WWWWWWWWWWWWWWWWWWWW
W---------WWW-----WW
W---W--WW----X-----W
W------------WWX---W
W--W-----W-------W-W
W-W----------------W
WWXWW---W-------XWWW
W-----------W-WW--XW
WW---W---W-W-------W
WWW----------W-----W
W----------XX--W---W
WW-WW------W---W--WW
W-----W-W-W---WW---W
W--W-W-W-----W-----W
W------WW--------W-W
W-W-W--W-W--W------W
W-----------------WW
W-----------W---W-WW
WW------W-----W----W
WWWWWWWWWWWWWWWWWWWW
