WWWWWWWWWWWWWWWWWWWW
W-----------W-W----W
W-------W-W--------W
W---W--WWW-W-------W
W---W--X--W----W---W
W----------W-W--W-WW
W--WW---W----------W
WW-------WW--------W
W-WX------X--------W
W-WW-----WW----W---W
W---W--XW-W--WW----W
W--------W--W--WW-WW
W-WW---W-------W---W
W--W-----W-WXW---WWW
W-------WW--------WW
W------W--------W--W
W---------WW-------W
W----WW--WX-------WW
W--W---W---------W-W
WWWWWWWWWWWWWWWWWWWW
