WWWWWWWWWWWWWWWWWWWW
W---W--------W---W-W
W---W--------------W
W----------W--W--W-W
W--W----------W----W
W-W-W----W-W--W----W
W-W----------------W
W-------WW---X-----W
W-W--------W---WW--W
W-----W-----W------W
W--------W-W-------W
W---W--W-----W----WW
W------------------W
W---------------WW-W
W-W----------------W
W-----W-X-----W----W
W--------W-----W---W
W---W-WW---W-W----WW
W-------------W----W
WWWWWWWWWWWWWWWWWWWW
