WWWWWWWWWWWWWWWWWWWW
W---WW--W-WW------WW
W-----W-W------WW--W
W----WWW-------W---W
WW-----W-----WWW---W
W---W---W--WW-----WW
W-WW--W-W----W-----W
W-------W--W--W--W-W
W----W---------W---W
WW--W----X----W-W--W
WW--W---W------W---W
W---------W--W-W---W
WW-------------W--WW
WW---W-------------W
WW---W--WW--------WW
W---------WXWW-WW-WW
W---------WW--W---WW
WW-----WW-----W----W
WW-W--W-----W-W-W-WW
WWWWWWWWWWWWWWWWWWWW
