WWWWWWWWWWWWWWWWWWWW
W-----W---------W--W
W------------W---W-W
W------------------W
W---W-W--W---------W
W---------W--------W
WW-W----------W----W
W----------------W-W
W--------------WW--W
WW----WX---------W-W
W---W--------W--WW-W
W-------W----------W
W-------W---------WW
W---X-W-W--W-------W
W------W-W---W-----W
W-----------W-WW--WW
WW----W------------W
WW---------W-------W
W--------------WW--W
WWWWWWWWWWWWWWWWWWWW
