WWWWWWWWWWWWWWWWWWWW
W---------------X--W
W----------------X-W
W------------------W
W----------------X-W
W------------------W
W------------------W
W------------------W
W-----------X------W
W------------------W
W-----------X------W
W------------------W
W------------------W
W------------------W
W-----W------WWW---W
W-XW-WWWWWW--WWW---W
W--W-WWWWWW--WWW---W
W--W-WWWWWW--WWW---W
W--W-WWWWWW--WWW---W
WWWWWWWWWWWWWWWWWWWW
