WWWWWWWWWWWWWWWWWWWW
W---WW--W---W-W----W
W----X-WX-------W-WW
W---------------W--W
W---------W----WW--W
WW-----W----W-W--W-W
W--W-----W---W-----W
W---W--W--X-WW-----W
WW-------------W---W
W--W-W---X-W-------W
W-----W---------W--W
W-W---------W------W
W--W----------WWW--W
W---W---X-W----W---W
W--W------------W--W
W----------W-------W
WW--------W-----W-XW
W-----W------------W
W-----W------W-----W
WWWWWWWWWWWWWWWWWWWW
