WWWWWWWWWWWWWWWWWWWW
W-------WW-W-W----WW
W---------W--X--W-WW
W----W-----WWW-----W
W--------W---------W
W----WXW-W-----W---W
W---W----W--W--W-WWW
W-----W--W------WW-W
W-----------W------W
W-----WWW---WW-W--WW
WW----WX--------X--W
W----------WX------W
W---W--------------W
W-W----------W-W--WW
WW--W-W-------WW---W
W---W-W---WW-W----WW
W-W----W-W-W------WW
W-W---W-W---WW---W-W
W--W----W--W-------W
WWWWWWWWWWWWWWWWWWWW
