WWWWWWWWWWWWWWWWWWWW
W-----------W-W---WW
W----WW-----------WW
W----W-------------W
W-W--------------W-W
W--W--------W--W---W
W-----W-W---W-----XW
W--------W--W---W--W
W--WW-------------WW
WW--W---------WX---W
W-----W------------W
W----W---W-W-----W-W
W--X-----W--------WW
W------W-W---------W
W-----------W------W
W---W--X-----------W
W----W-----W---W---W
W-W--W-------------W
W------W-W---W-----W
WWWWWWWWWWWWWWWWWWWW
