WWWWWWWWWWWWWWWWWWWW
W-----------W------W
W-----WW-W---------W
W--------W---------W
W-------WX---------W
W-W--------W-W-----W
W----W-W--W----W-W-W
W-W---------W-----WW
W----W--W---------WW
W---------W------W-W
W-----W--------W---W
W-----------------WW
W------------X-----W
W--------------W---W
W-W--W-------------W
W-----WW---WW------W
W-------W-------WW-W
W------W------W----W
W-W--------W-------W
WWWWWWWWWWWWWWWWWWWW
