WWWWWWWWWWWWWWWWWWWW
W------W---------WWW
W----------X-----W-W
W-------W----W-----W
W---W----W---------W
W----W-W-----------W
W---WW------W------W
W-W---------WW-----W
W------------------W
W-------------W----W
W-X---------W-W----W
W--------------WXWWW
W------W-----------W
W----W-----W--W---WW
W-W---------------WW
W-------W--W-------W
W------------------W
W---------W--------W
W---W--W-----------W
WWWWWWWWWWWWWWWWWWWW
