WWWWWWWWWWWWWWWWWWWW
W-------W-W-W-WW---W
W-------XX------WW-W
W-----------W------W
W-----------------WW
W-----X------------W
W--------------WW--W
W------W--W--------W
W-W--------------X-W
W----W------W--W---W
W------W-----------W
W-------W-W-W----XWW
W---W-------W-W----W
W------------------W
W-WW---------------W
WXW----W-----W--W--W
W--------W---------W
WW-----WWX---W----WW
W------------------W
WWWWWWWWWWWWWWWWWWWW
