WWWWWWWWWWWWWWWWWWWW
W-------------X----W
W------W-WW--W-----W
W----W---W-----W-W-W
W-------W-W--W-----W
W-------W---WW-W-W-W
WX-----W----------WW
W--W---XW-----W-X--W
WW--W--X---X----WW-W
W---W------W-W-WW--W
W-W-----W--------WWW
W--W--W---------W--W
W----W----WW-------W
WW---W---WW-WW----WW
W---W--W----W---W--W
W-WW--W---------W-WW
W---W-----WW------WW
W-WW-------------W-W
W-------W----W--W--W
WWWWWWWWWWWWWWWWWWWW
