WWWWWWWWWWWWWWWWWWWW
W-----W------------W
W------------------W
W-----W--W--WW-----W
W-W-----W----------W
WWW---WXW-WW-------W
WW-W-W-W-----------W
W--W-W-----WW-W--W-W
W--W-X----W--------W
W----------------W-W
W-X-W--------W-W---W
W----WWW-----------W
W--W--W-W----------W
W-----------W---W--W
W---W------------W-W
W--W----------W----W
W-----W------------W
WW-------WW-X------W
W----W--------W---WW
WWWWWWWWWWWWWWWWWWWW
