WWWWWWWWWWWWWWWWWWWW
W-----------W-W-W--W
W-------W------W--WW
W---W------W--W-W--W
W---------------W--W
W-W--------W------WW
W-W--------W---X---W
W-W---W--X--------WW
W-----WW--W--W-----W
W-----------------WW
W-W---------WWW-W--W
W-WW----W--W---W---W
W------W-----------W
W----------W-------W
W-W-W--W-X-------W-W
W---XW----X-W------W
W---W---W----------W
W---X-----W-------WW
W-X--W---W---------W
WWWWWWWWWWWWWWWWWWWW
