WWWWWWWWWWWWWWWWWWWW
W------------------W
W------------------W
W------------------W
W------------------W
W------------------W
W-----WWWW---------W
W-----WWWW---------W
W------------------W
W----------------W-W
W----------------W-W
W----------------W-W
W------WW----------W
W------WW-------WWWW
W-----XWW-------WWWW
W------WW-------WWWW
W------WW-------WWWW
W------WW------WWWWW
WX-----WW------WWWWW
WWWWWWWWWWWWWWWWWWWW
