WWWWWWWWWWWWWWWWWWWW
W----W-----------XWW
W----------------WWW
W----W-----W--XW-WWW
W--------------W-W-W
WW---W-WWW----W---WW
W--------W----W----W
W-------W-------WWWW
WWW-W------W-XW----W
WW-W-W-W---W---W---W
W---------------W--W
WWWWW------------WWW
W--W----------W--WWW
W--X----W---W---W--W
W----W-W----WW----WW
W---------W------X-W
W--W-W---WW--------W
W-----------WW---W-W
W-W---WWXW-W----X-WW
WWWWWWWWWWWWWWWWWWWW
