WWWWWWWWWWWWWWWWWWWW
W-------W------X--WW
W----W-WW-------W--W
W------------------W
WW-W-----W--W----W-W
WWW----W---WWWW---WW
W-------WW--W------W
W--------WW--------W
W-W---WW----W------W
W--------WW-W------W
W----WW--W-------W-W
W--WW---W---------WW
W-X-WW-------------W
W--W--W---WW------WW
W-W----WW---W------W
W---W--W-W-------W-W
W--W----------W----W
W--WX-W------------W
W-WW---W---W----W--W
WWWWWWWWWWWWWWWWWWWW
