WWWWWWWWWWWWWWWWWWWW
W---WW-------X----WW
W------------------W
W---W--------W----WW
W------------------W
W-------WW-W-----WWW
W--------------W---W
W------X-----W-WWW-W
W------------------W
WW------W---W-W----W
WX--W--------W---W-W
W------------------W
WW-------W--W-W----W
W---------------W--W
W-W----------------W
W-W----W-----------W
W-W--W--X-----W----W
W-----------W------W
W--WWW-----W-WW----W
WWWWWWWWWWWWWWWWWWWW
