WWWWWWWWWWWWWWWWWWWW
W--------------W---W
W------W----------WW
W-------------W----W
W-----WWW---------WW
W-X-WW--X--W-------W
W---X-W-W----------W
W------W-----------W
W-------W--W-------W
WW--W---W----------W
W------------W-----W
W--W---------X-----W
W----W-------------W
W---X-----W--------W
W-------W---W------W
W---W------WW-----WW
W----WW---W--------W
W---W--------------W
W------W--WW------XW
WWWWWWWWWWWWWWWWWWWW
