WWWWWWWWWWWWWWWWWWWW
W--------X-W-------W
W-----W------------W
W------------------W
W------------------W
W---------W------WWW
WX---W-W----W--WW--W
W------------WW----W
W---WW-W---W---WW--W
W---------------W--W
W---W-----------W--W
W---W-WX-----------W
W----W-W---------W-W
W--------W---------W
W----W-----WW------W
W-W--------X-------W
WW-------W--W------W
W----W-------W-----W
W-W---W---------X--W
WWWWWWWWWWWWWWWWWWWW
