WWWWWWWWWWWWWWWWWWWW
W---W-W--W---------W
W--------W---------W
W------------------W
W--------W----W----W
W---------------W--W
W---W----WW-------XW
W-----------WW-----W
W-----X--WW-----W-XW
W------WW-WW-------W
W--W-----------X---W
WW--W------------W-W
W------W--W--------W
WW------W-W-----W--W
WW-------W-W---W---W
W----W-WW---------WW
W---X-------------XW
W--W--W-----W------W
W---W--W----W--W--WW
WWWWWWWWWWWWWWWWWWWW
