WWWWWWWWWWWWWWWWWWWW
W---WW---W-------W-W
W-----------W---WW-W
W---W---------W----W
W----------------W-W
W------------------W
WW-------X--W-W-W--W
W------WWWWW------WW
W---W--------W----WW
W-WW-W-----WX------W
W--W------------WW-W
W-W--W-------------W
W----W-----WWW-----W
W------W----WW----WW
W----W-W---W----W--W
WW------W---WWW---XW
WW---------WW------W
W-WX---------------W
W---------XW------WW
WWWWWWWWWWWWWWWWWWWW
