WWWWWWWWWWWWWWWWWWWW
W---W----W--W------W
W-------W--------X-W
W-----WW------W----W
W--------W------X--W
W---W-W---W----WWW-W
W-W-------W--------W
W--W----W-----W----W
W------W--W-W----W-W
WWWW---W-----------W
W-WW----------W--X-W
W-W--------------W-W
WW------------W----W
W-----W---W--W-----W
W--X---W--WX---WW--W
W--W-W---W-W----W--W
W--W------------W--W
W------------------W
W-W-WW-----X--WWW--W
WWWWWWWWWWWWWWWWWWWW
