WWWWWWWWWWWWWWWWWWWW
W---WW-----W-W---X-W
W------W-W----W----W
W-----WW--W--------W
W-----W---W--W-----W
W--------W------WW-W
W------------WWW---W
WW----X---W---W----W
W-WW---W-W---------W
W-----W-----W--W---W
W---------W--W-W-W-W
WX------------W----W
W----W-------------W
W----W-W-------X---W
W--W-----W--WWW-WW-W
W--------WW---W-WW-W
W-W-W-W-------WW-WWW
WW-W------W---W----W
W-W------W----W----W
WWWWWWWWWWWWWWWWWWWW
