WWWWWWWWWWWWWWWWWWWW
W--------W-------WWW
W---WW-------W-----W
W------W----------WW
W-W--------------W-W
W------------------W
W---------X-----X--W
W-W---W--W---------W
W-W----------W-----W
W-----------------WW
W-----X--WX-W------W
W---------W--------W
W---------W-----X--W
W-----WX-------W-W-W
W------W--W--W-W---W
W--W------------W--W
W--W-W-------WW----W
W---X-W-W-W-----W--W
W------W-----------W
WWWWWWWWWWWWWWWWWWWW
