WWWWWWWWWWWWWWWWWWWW
W------------W----WW
W---------W--------W
W-------------W----W
W--------X------W-WW
WW-------W-W-------W
W------------------W
W-WW----W----------W
W----X--W---W------W
W---WW-----WXW-----W
W---W-W---X--------W
W--------W---W-W--WW
W-WW-W----W--X-W---W
W------------------W
W--WW--------------W
W--WW-W----W--W----W
W---W-W-----X------W
WX-W---------------W
W--------W---------W
WWWWWWWWWWWWWWWWWWWW
