WWWWWWWWWWWWWWWWWWWW
W---W--------WW----W
W------W---W-------W
W-----WX-----X-----W
WWW---------W------W
W---WW---------X---W
WX--X--------------W
W---WW--------W----W
W-W-W--------W--W--W
W--------W--W-----WW
W-------W------WW--W
W------W-----W-WW--W
W---------W-W------W
W---WW------WX-----W
W------------------W
WW-------W-W--W----W
W------W--X--------W
W------------------W
WW-----------W-----W
WWWWWWWWWWWWWWWWWWWW
