WWWWWWWWWWWWWWWWWWWW
W--------W-------WXW
W---W---------WW---W
W------------------W
W------W-W---------W
W-------WW--W------W
W---X----W----W----W
W-WWW--WWW---W--W--W
WW-----W---WWW---WWW
WW-----W---------W-W
W-W----WXW---W-----W
W--------W---------W
W-W--W--WW----W----W
WW-W---------WW--WWW
WW------W---WW-W-W-W
W---W----WW----W--XW
WW--W---W--W------WW
W--------WW--------W
W--------W------W-WW
WWWWWWWWWWWWWWWWWWWW
