WWWWWWWWWWWWWWWWWWWW
W------X-----------W
W-----W---------W--W
W---W---W------WX-XW
WW-----WW---X------W
WW-----W---------WWW
W--------------W---W
WW---W------W-WWW--W
W--W-----W-X---W-W-W
W--W--WW----W----W-W
W-W-W-WW--W-----W--W
WW----------W---W--W
W-WW--------W--W-W-W
W---W-W-----W--W-W-W
W-W------W-W--WW-W-W
WW-----W-------W---W
W---------W---W----W
W-W------W-WW------W
W--W------WW--W-W--W
WWWWWWWWWWWWWWWWWWWW
