WWWWWWWWWWWWWWWWWWWW
W--------X--WW----XW
W--W-W----WW-W-----W
W-X---W-----W-WW--WW
WW----W-W-------X-WW
W-W--X---------W-X-W
W------------W-----W
W----------W--W-W--W
WW-W--W-----------WW
W-WXW-W--W-----W---W
W-W-----XW-X--WW-WWW
WW-W-W--W--W---W---W
W-X----WWXW---WX-W-W
W-W-----WWW-W-W----W
W---WX-------------W
WW----X-------WW--XW
WW---X--------W----W
W----WWWW------W---W
W---W---------X----W
WWWWWWWWWWWWWWWWWWWW
