WWWWWWWWWWWWWWWWWWWW
W----------X---X---W
W----------W-----X-W
W------X----W------W
W------------------W
W----------------W-W
W----------W-------W
W----------X-------W
W------------------W
W------W-W-------W-W
W-------X----------W
W---X----------X---W
W------------------W
W----X-------------W
W----XX------X-----W
W--X---X-----------W
W---W----W---------W
W-W----------------W
W-------------X--X-W
WWWWWWWWWWWWWWWWWWWW
