WWWWWWWWWWWWWWWWWWWW
W------------------W
WW--------------X--W
W------------------W
W------------X--X--W
W------------------W
W------------------W
W------------------W
W-------W----W-----W
W------------------W
W-----------X------W
W--------W---------W
W-------X----------W
W--X---X--X-W------W
W------------------W
W----------WW-XX---W
W------X-----------W
W--------W-W-------W
W------------------W
WWWWWWWWWWWWWWWWWWWW
