WWWWWWWWWWWWWWWWWWWW
WD--------W--------W
W---------W--------W
W---------WWWWW--X-W
W---WWW---W--------W
W---------W---W----W
W---X-----W--WW---XW
W---------W---WWWWWW
W-W-------WW-------W
WWWWW--W---WWW-----W
WX-----W----------WW
WW--WWWWWWW--------W
WW--W--------------W
W---W--WWWW-----X--W
WWWWW--W-----------W
W------W--WWWWWWWWWW
W--WWWWW--W--------W
W--W------W--WWWW-XW
W-XW------------W--W
WWWWWWWWWWWWWWWWWWWW