WWWWWWWWWWWWWWWWWWWW
W------W-----------W
W------W-----------W
W------W-----------W
W------W-----------W
W------W-----------W
W------W-----------W
W------W-----------W
W------W-----------W
W------W-----------W
W------------------W
W------------------W
W------------------W
W------------------W
W----------X------XW
W------------------W
W--------------X---W
W------------------W
W----------X------XW
WWWWWWWWWWWWWWWWWWWW