WWWWWWWWWWWWWWWWWWWW
W--------XX--XWX---W
W-W--------W----X--W
W----------W-------W
W--W--W-----W------W
W----WW-W-----W-W--W
W-------W-------W--W
W--W-------W-----WWW
W------WWXW--------W
W-W--W-------------W
W--------W----W---WW
W-X---W------------W
W--X----XW-W-WX---WW
W-------W------X---W
WX--------W----X---W
W--W------------WW-W
W-W---------------WW
WX---WWX------W-XW-W
W-X----------------W
WWWWWWWWWWWWWWWWWWWW
