WWWWWWWWWWWWWWWWWWWW
W------------------W
W------------------W
W-----W-X---------WW
W-----W-----X------W
W-W---W------------W
W--W--X------------W
W------------------W
W--W---------X-----W
WW---X-------WW----W
W----W-------------W
W----WW------------W
W----W--W----------W
W----W-------------W
W----W-XWWW------WWW
W----W-----------XWW
W----W-----------W-W
W------------------W
W------------------W
WWWWWWWWWWWWWWWWWWWW
