WWWWWWWWWWWWWWWWWWWW
W------------------W
W------------------W
W------------X-----W
W------------------W
W-----------------WW
W-----------W-----WW
WW----------------WW
W----------X-------W
W---------W--------W
W----------WW------W
W--------------W---W
W-----------X-----WW
W--WWWW--------WWWWW
W------------------W
W-W-----W----------W
W------------------W
W------------------W
W------------------W
WWWWWWWWWWWWWWWWWWWW
