WWWWWWWWWWWWWWWWWWWW
W------------------W
W------------------W
W------------------W
W------------------W
W------------W--W--W
W------------W--W--W
W-----------------XW
W------------------W
W-------------WXW--W
W------------------W
W-W----------------W
W------------------W
W------------X-----W
W-WWWW-------W-W---W
W-W--W-------------W
W------------------W
W---------------X--W
W------------------W
WWWWWWWWWWWWWWWWWWWW
