WWWWWWWWWWWWWWWWWWWW
W-------------------
W----------W------WW
W-----------------XW
W---------WWWW--WWWW
W------------------W
WW-----------------W
W------------WW---WW
WW----------------WW
W-----W--WWWWW-----W
W------------------W
W-W--W-----------W-W
W-X--W-------------W
W-------------W--W-W
W-W-----------W----W
W-W--W-------------W
W------------------W
W-WW-------X-------W
W------------------W
WWWWWWWWWWWWWWWWWWWW
