WWWWWWWWWWWWWWWWWWWW
-------------------W
W------------------W
W-----------W---W--W
W--------W---------W
W-W------W------W--W
W--X--W------------W
W---------WWWW--W-WW
WWWW------------W--W
W---------W----W--WW
WW---------W-WWW---W
WW-----------------W
W-----------------WW
WW---------WW-----WW
W-----------------WW
W------------------W
W-----------------WW
W------------------W
W------------------W
WWWWWWWWWWWWWWWWWWWW
