WWWWWWWWWWWWWWWWWWWW
W-------------------
W------------------W
W----------------WWW
W----------X------XW
WW-W--------------WW
W--W--------------WW
W--W----------WWW-WW
W--W------W--------W
W--W---------------W
W--WWWW------WWW---W
W---X--------W-----W
W---W--------------W
WWWXW--------W--W--W
W-----X------------W
W----WWW-----------W
W-W-------------W--W
W-W----------------W
W------------------W
WWWWWWWWWWWWWWWWWWWW
