WWWWWWWWWWWWWWWWWWWW
W------------------W
W-----W------------W
W-----W---W--------W
W-----W------------W
W-W---W------W---WXW
W------------------W
WWWW---------------W
W----W-WWW----X----W
W------------------W
W------------------W
W------------------W
W------------W-----W
W------------W-----W
WW-----------W-----W
WW-----------W-----W
WW-W---------------W
WWX----------------W
W------------------W
WWWWWWWWWWWWWWWWWWWW
