WWWWWWWWWWWWWWWWWWWW
W-----------------WW
W----WW-----------WW
W-----W----------X-W
W-----------------WW
W--XWWWW-----X-----W
W----------W-------W
W---X--------------W
WXWW---------------W
W-----------W-----WW
WWWW------W-W------W
W-------W-W-W------W
W---------WWW----WWW
W--XW-X-----W------W
W------------------W
W----WWWWWW--------W
------------X------W
W-----------------WW
W----W---W--------WW
WWWWWWW-WWWWWWWWWWWW
