WWWWWWWWWWWWWWWWWWWW
W------------------W
W------------------W
W--------W---------W
W-----X---X--------W
W------------------W
W----W-----------WWW
W------------------W
W----WW----WW-WW---W
W-----WWW---W----W-W
W--X---------------W
W------------------W
W------W-----W-----W
W------------W-W-W-W
W-----W------W-----W
W------W-----W-----W
W-----WWW---X------W
W------W-----------W
W------------------W
WWWWWWWWWWWWWWWWWWWW
