WWWWWWWWWWWWWWWWWWWW
W-------W-----------
W------WW----------W
W------------------W
W------------------W
W------------------W
W-------W-W--------W
W------------------W
W---------W------WWW
W------------------W
WW-----------------W
W-------------W--X-W
W--------WWW--W----W
W---W-W-------W----W
W------------------W
W------------------W
W------------------W
W-----------------WW
W--X---------------W
WWWWWWWWWWWWWWWWWWWW
