WWWWWWWWWWWWWWWWWWWW
W------------------W
W------------------W
W------------------W
W------------------W
W-------------W----W
W-W-----------W-W--W
W------W-----------W
W---------------W-WW
WWW---------------WW
W-----WWW-W-W------W
W-W----------------W
W-WW----WWWWWXW---XW
W-W-------W--------W
W-WWW----------WW--W
W-WW---XW----------W
W-W----------------W
W------------------W
W------------------W
WWWWWWWWWWWWWWWWWWWW
