WWWWWWWWWWWWWWWWWWWW
W------------------W
W------------------W
W-------------WW--WW
W-----------------WW
W-----WWWWW---WW---W
W--------------W---W
W-W-W-W------------W
W--------W---------W
W------------W-----W
W-W-----------W----W
W-----------------WW
W------------X----WW
W-WW--------------WW
W--X-----W-X--WW--WW
W--W-----W---------W
W--W-----W---------W
W--W---------------W
W--------W---------W
WWWWWWWWWWWWWWWWWWWW
