WWWWWWWWWWWWWWWWWWWW
W------------------W
W------------------W
W------X---W-------W
W-----------------WW
W-----X-WWWWW---X--W
WWW-----W--W-------W
W-W-W-------------XW
W-------XWWWW------W
W--------------W---W
W-W--W----WX---W---W
W------WW------X---W
W----WWW-------W---W
W-X--W-W---------W-W
W------W-----------W
W-WW---W-----XWW---W
W------------------W
W-----------X------W
W------------------W
WWWWWWWWWWWWWWWWWWWW
