WWWWWWWWWWWWWWWWWWWW
W------------------W
W------------------W
W------------------W
W-------------W--W-W
WWW-----------W--W-W
W--------WWW--W----W
WWW-----------W-WWWW
W---------WWWWWWW-XW
WWW---W------------W
W-W-----------W----W
W-W----------WWWW--W
W-W--W-------------W
W------------------W
W-----------------WW
W------------------W
WW-----------------W
W---------X--------W
WW---------------WWW
WWWWWWWWWWWWWWWWWWWW
