WWWWWWWWWWWWWWWWWWWW
W------------------W
W------------------W
W------------------W
W-----W-WWW-W------W
W-W-W---X----------W
W-W-------------W--W
W------W----------XW
W------------------W
W---------------W-WW
W---------------W--W
WW--------------W--W
WW-W--WW--------W-WW
W---------------W-WW
W------W----------WW
W---X-------------WW
W------------------W
W------------------W
W------------------W
WWWWWWWWWWWWWWWWWWWW
