WWWWWWWWWWWWWWWWWWWW
W--------------W---W
W------------------W
W----W-W-----------W
W---------W---X----W
W--WWWWWWWWX--W----W
W------X-----------W
W------------------W
WWWX-------X-------W
W--------------WWWWW
W------X--------WW-W
W-X---W------------W
W----WW------------W
W----WW----------WXW
W-----WWWWW------W-W
W----------------W-W
W------------X---W-W
W------------W---W-W
W------------------W
WWWWWWWWWWWWWWWWWWWW
