WWWWWWWWWWWWWWWWWWWW
W-----------------WW
W------------------W
W----X------W-W-WWWW
W-----------W------W
W---X-------------XW
W---W-------WWW---WW
W--------WW--W-----W
W------------W-----W
W---W-------WW-----W
W--------------WWWWW
W--------------W-WWW
W---------WWWWWW---W
WW-------------WWWWW
W-----------------WW
W--------------W---W
W-W--X-------------W
W-WW---W-----------W
-------------------W
WWWWWWWWWWWWWWWWWWWW
