WWWWWWWWWWWWWWWWWWWW
W-------------------
W------------------W
W------------------W
W------------------W
W----------------W-W
W------------------W
WW-------WW--------W
W-----WW-------W---W
W-----------W--W---W
W------WWW-----WX-WW
W--W---------------W
W------------------W
W------------------W
W--WWWWW-------W--WW
W---XW---------W--WW
W------------------W
W------------------W
W------------------W
WWWWWWWWWWWWWWWWWWWW
