WWWWWWWWWWWWWWWWWWWW
W------------------W
W----------------X-W
W-----W------------W
W------------------W
W-W--------W-W---W-W
W-----W-W----------W
W------------------W
WW-W------WW-------W
W---------W--------W
W---------WWW------W
W---------WWWWW-W--W
W-----------------WW
W------W-----------W
W---------------W-WW
W------------------W
W-------W---------WW
W-----------------XW
W------------------W
WWWWWWWWWWWWWWWWWWWW
