WWWWWWWWWWWWWWWWWWWW
W------------------W
W------------------W
W------------X---X-W
W------------------W
W------------------W
W------------------W
W----W-------------W
W----------------W-W
WWWW-------------W-W
W---------X--------W
W------------------W
W------------------W
WW---------X------XW
WW-W---------------W
W--W------XWW-----WW
W------------------W
W--W--------------WW
W------------------W
WWWWWWWWWWWWWWWWWWWW
