WWWWWWWWWWWWWWWWWWWW
W------------------W
W------------------W
W----WWW-----------W
W----WWWWWW-W---WWWW
W---------------X--W
WWWW-W-------------W
W------------------W
-------------------W
WW-----------------W
W-----------------WW
W---------X-W------W
W---W--W-----------W
W------W---X-------W
W-X----------------W
W-------------W--WWW
W------W---WWWW----W
W------------------W
W------------------W
WWWWWWWWWWWWWWWWWWWW
