WWWWWWWWWWWWWWWWWWWW
W------------------W
W--------X----X----W
W------------------W
W-------W-W--------W
W-W----------------W
W-W-----WWX---WW--WW
W-W-----------W----W
W--------------X---W
W-----------------WW
W-----W-WWX-W-WWWXWW
W-----W------------W
W------------X-----W
WWW--------WWW----WW
WW-------WW--------W
W------X-----------W
W--W---W------W----W
W-------------W----W
W-------------W----W
WWWWWWWWWWWWWWWWWWWW
