WWWWWWWWWWWWWWWWWWWW
W------------------W
W------------------W
W----------------X-W
W-------W---------XW
W------------------W
W-----------------XW
W------------------W
W------------W-----W
W------------------W
W------------------W
W-W----W-----------W
W-WW----------W----W
W-W----------------W
W-W--W-------------W
W-W----------------W
W----WWWW----WWWW--W
W---X--------------W
W------------------W
WWWWWWWWWWWWWWWWWWWW
