WWWWWWWWWWWWWWWWWWWW
W------------------W
W-------X----------W
W-------W-WW----X--W
W--------------WWWWW
W------------------W
W----WWWWWW--------W
W------------------W
W-----------W------W
W-----------W------W
W-----------W------W
W--------X--WW-----W
W------------------W
W--W-----------W---W
W--W---------------W
W-----W-----------WW
W------------------W
W------------------W
W------------------W
WWWWWWWWWWWWWWWWWWWW
