WWWWWWWW-WWWWWWWWWWW
W------------------W
----------W--------W
W----WW--WW--------W
W--------W-------WXW
W--------X---------W
W-------------X----W
W----------------XWW
W------X------W---WW
W-----------------XW
W-----------------WW
W----------X-------W
W----------W-------W
W----X-----W------XW
W----------W-------W
WW----W----WX------W
W-----W------------W
WW----W----WWWW----W
W------------------W
WWWWWWWWWWWWWWWWWWWW
