WWWWWWWWWWWWWWWWWWWW
W------------------W
W------------------W
W----------------WWW
W------X-----------W
W------W-----------W
WW--WW-W------X----W
W------W-WWWW-----WW
W------W---W-----WWW
W-WW---W-W-W-----WWW
W----W------------WW
W----W-------------W
W----W-------------W
WW-W------W--------W
WW-W----WWWWW------W
WW-------WWW-----X-W
WWXW--W-----W------W
W---WWW------------W
W-------------------
WWWWWWWWWWWWWWWWWWWW
