WWWWWWWWWWWWWWWWWWWW
W------------------W
W------------------W
W--------WW-W--X--WW
W--------------W---W
W------------------W
WWWW---------------W
W------------------W
WWWWW-------------WW
W------------------W
WWW--------X-------W
WWWW--------------WW
W------------X----XW
WWW----------------W
WW-----------------W
W------------------W
W-----------------WW
W-W-------------W--W
W------------------W
WWWWWWWWWWWWWWWWWWWW
