WWWWWWWWWWWWWWWWWWWW
W------------------W
W------------------W
W------------------W
W------------------W
W----------------W-W
W------W---------W-W
W-W--------X---X-W-W
W-W---WWWWWW-------W
W---------W--------W
W---------W--------W
W------------------W
W------------------W
W---X-----------X-WW
W-----------------WW
W---------------W-WW
W---------------W--W
W------------------W
W------------------W
WWWWWWWWWWWWWWWWWWWW
