WWWWWWWWWWWWWWWWWWWW
W------------------W
W------------------W
W-------W----------W
W-----------X------W
W-----W-----------WW
W------------------W
W-----W------------W
W-----------W------W
W----------W-------W
W-X--------W-------W
W----------W-WW---WW
W----------W-W-----W
W------------------W
WWWW-XWXWW---WWW--WW
W-----------------WW
WWW----W----------WW
W-----------------WW
W----WWWW----------W
WWWWWWWWWWWWWWWWWWWW
