WWWWWWWWWWWWWWWWWWWW
W------------------W
W------------------W
W-----------------XW
W--------------W---W
W--------------W--WW
W-----------------WW
W-----------------WW
W-----------------WW
W------------------W
WW---------------WWW
WW-------W---------W
W--------W---------W
WWW----------W-----W
WWWW------X--W-----W
W------------W-----W
W--------WWWWWW-W--W
W-------------W----W
W------------------W
WWWWWWWWWWWWWWWWWWWW
