WWWWWWWWWWWWWWWWWWWW
W---------W--------W
W---------W--------W
W---------WX------WW
W---------WX-------W
W-----------------WW
W------------------W
W----W-------------W
W---------X--------W
W------W--W--------W
W------------------W
W------------------W
W------------------W
W-------X-------X--W
W-W----------------W
W------------------W
W--X-W---X---------W
W------------------W
W------------------W
WWWWWWWWWWWWWWWWWWWW
