WWWWWWWWWWWWWWWWWWWW
W------------------W
W-------------W----W
W-----------W-W---XW
W-------------WWW-WW
W-------------W----W
WW------------W----W
W----------W--W----W
W----------W--W----W
W--W-------W--W----W
W----------W-------W
W----------W--W----W
W----------WW-W--X-W
W-----------------XW
W-------------WWWWWW
W-W----------------W
W-----W------------W
W------------------W
W------------------W
WWWWWWWWWWWWWWWWWWWW
