WWWWWWWWWWWWWWWWWWWW
W------------------W
W--------W---------W
W----W-------------W
W----W---WWWWW-----W
W----W-------------W
W------------------W
W----W-----W-------W
WW---------W-------W
WWW--------W-------W
W----------W-------W
W-----------------XW
WW-----------------W
W---------W--------W
W------------------W
W------------------W
W--------W-W-------W
W--W--W------------W
W------------------W
WWWWWWWWWWWWWWWWWWWW
