WWWWWWWWWWWWWWWWWWWW
W------------------W
W---------W--------W
W----W----W-----W-XW
W-------W-W-W---W-XW
W---------------W-WW
W-W----------------W
WWW----------W-----W
W-W----------W-----W
WWWW---------W-----W
W-W---X------------W
W------------------W
W------------------W
W---------------W--W
W---------------W--W
WWWW----W-------W-XW
W-------W--WWW--W--W
W------------------W
W------------------W
WWWWWWWWWWWWWWWWWWWW
