WWWWWWWWWWWWWWWWWWWW
W------------------W
W------------------W
W------------------W
W----W-------------W
WWW--W-------------W
W------------------W
WWWWWWW----------W-W
W----------------WWW
W----------------W-W
W-------WW--W----W-W
W--------W--W----W-W
W------------------W
W-----------W------W
W-------WWWWWW-----W
W-------WW---------W
W--X---------------W
W------------------W
-------------------W
WWWWWWWWWWWWWWWWWWWW
