WWWWWWWWWWWWWWWWWWWW
W------------------W
W------------------W
W------------------W
W------------------W
W----W-------------W
W------W--W--------W
W---WWW---W-------XW
W-W----------W----WW
W------------W-----W
W---W-WWWW---W-----W
W------------------W
W----------W-W-----W
W------------------W
WW--W--------------W
W-----W----------WWW
W------------------W
W---------------WW-W
W------------------W
WWWWWWWWWWWWWWWWWWWW
