WWWWWWWWWWWWWWWWWWWW
W-------------------
W-------------W----W
W-------------WW---W
W----WWWW-----WW---W
W------------------W
W------------------W
W-------W---------WW
WWWWW---W----------W
W-----------------WW
W---X--------------W
W----W-------------W
WW-----------------W
W-----------------WW
W---W-------------XW
W------------------W
W------------------W
W------------------W
W----WWW-----------W
WWWWWWWWWWWWWWWWWWWW
