WWWWWWWWWWWWWWWWWWWW
W------------------W
W------------------W
W----WWWW------WWW-W
W------------------W
W---------------X--W
W------WW-W--------W
W------------------W
W-------------W----W
W--------WWW-------W
W-W--------------W-W
W---------WWW------W
W-WWW------W-------W
W-WW-------W-----W-W
W----------W-----W-W
W----------W----WW-W
W---W-----------W--W
W------------------W
W------------------W
WWWWWWWWWWWWWWWWWWWW
