WWWWWWWWWWWWWWWWWWWW
W------------------W
W------------------W
W------------------W
W---------------W--W
W-W----------------W
W----W-------------W
W-WW---------------W
W------------W-----W
W-W---W-----------XW
WWW----------------W
WWW-----W----------W
W-W---WW-----------W
W-W---WWW---W------W
WWW---------W------W
W-W---------W------W
W-W---W------------W
W------------------W
W------------------W
WWWWWWWWWWWWWWWWWWWW
