WWWWWWWWWWWWWWWWWWWW
W------------------W
W------------------W
W------------WW-W--W
W------------W-----W
W----W-------W-----W
W-W----------W-----W
W--------W---W-----W
W-W----------W-----W
W----------------W-W
W------------------W
W----------------W-W
W------------------W
W-----W------------W
W-------W----------W
W------------------W
W------WWWW--WWWWWXW
W------------------W
W------------------W
WWWWWWWWWWWWWWWWWWWW
