WWWWWWWWWWWWWWWWWWWW
W------------------W
W------------------W
W------------------W
W----W-------------W
W-W-----------W--X-W
W-------------W--WWW
W-------------W----W
W----W--------W----W
W----W--------W----W
W----W--------W---WW
W----W--------W---WW
W----WWWW----------W
W-------------W----W
W------------------W
W------------------W
W------------------W
W------------------W
W------------------W
WWWWWWWWWWWWWWWWWWWW
