WWWWWWWWWWWWWWWWWWWW
W------------------W
W------------------W
W-----W------------W
W------------------W
W------------------W
W---W-WW-----------W
W--WWWW------------W
W---W------WWW--W--W
W---W---WWWWWW--W--W
W---WWW-W-------W--W
W------------------W
W-W-----W----------W
WW------WW--W--WWW-W
W-------W----------W
W-------W----------W
W----W------------XW
W------------------W
W------------------W
WWWWWWWWWWWWWWWWWWWW
