WWWWWWWWWWWWWWWWWWWW
W------------------W
W------------------W
W------------------W
W------------------W
W-WWW-------------WW
W-W----X---W-------W
W-W----------------W
W-W-W--------------W
W------------------W
W------------------W
W-----W------------W
W-----W------------W
W---------------W--W
W---WWW-----W---W--W
W------------------W
W---------------W--W
W------------------W
W-------------------
WWWWWWWWWWWWWWWWWWWW
