WWWWWWWWWWWWWWWWWWWW
W------------------W
W------------------W
W------------------W
W------------------W
W----W-------------W
W------------------W
WW---WW------------W
W------------------W
WW-----------------W
WW---------W-------W
WW------------X----W
W-----------W------W
W-----------W------W
W---------W-W------W
W-----------W------W
W------------------W
W------------------W
W------------------W
WWWWWWWWWWWWWWWWWWWW
