WWWWWWWWWWWWWWWWWWWW
W------------------W
W------------------W
W------------------W
W------------------W
W------------------W
W------------------W
W----------W-W-----W
WW-----------------W
W--------------WWWWW
W------------------W
WW-------W---------W
W------------------W
W--------W-W-------W
W---WW-------------W
W-----------------XW
W-------------WW--WW
W------------------W
W------------------W
WWWWWWWWWWWWWWWWWWWW
