WWWWWWWWWWWWWWWWWWWW
W-----------------WW
W------------------W
W------------------W
W-------WW---------W
W-------W----------W
W-------W---------WW
W------------------W
WW---------W-W----XW
W------------------W
W-----------------WW
W------------------W
W-----------------WW
W-------W---------WW
W-------WW---------W
W--------W--------XW
W----W----------WWWW
-----W--------------
WW-----------------W
WWWWWWWWWWWWWWWWWWWW
