WWWWWWWWWWWWWWWWWWWW
W------------------W
W-----------W------W
W------------------W
W------W---------W-W
W----------W-W-----W
W---------------W-WW
W------------------W
W--W---------------W
W---W-------------XW
W---------W-----WWWW
W--------W---------W
W--W-----W---W-----W
W--WWW---W----W-WWWW
W-------------W----W
W--------W----W----W
W--W--W--W----WWWWXW
W------------------W
W-----------------XW
WWWWWWWWWWWWWWWWWWWW
