WWWWWWWWWWWWWWWWWWWW
-------------------W
W------------------W
W-------W----------W
W----------WW------W
W-----------W------W
W---X--WWWW-------WW
W-WWW--------------W
W------------------W
W---------W-------WW
W---W--------------W
W-----------------XW
W-----------------WW
W--WW--------------W
W------W-W---W-W--XW
W------------------W
W------W-----------W
W------W-----------W
W-W----------------W
WWWWWWWWWWWWWWWWWWWW
