WWWWWWWWWWWWWWWWWWWW
W------------------W
W-------------------
W------W------WWW-WW
W------------------W
W------------------W
W----WWW-----------W
W-----------------XW
W-----W---WWW-WWW-WW
W-----W------------W
W------------------W
W---------WWW------W
W-W----------------W
W------------------W
W------------------W
W---------W--------W
W-------W----------W
W----------------WWW
W------------------W
WWWWWWWWWWWWWWWWWWWW
