WWWWWWWWWWWWWWWWWWWW
W------------W-----W
W------------W-----W
W----W-------W-----W
W------------W-----W
W--W----W----W----WW
W-------W----W-----W
W-------W---------WW
W-----------------XW
W-------------W----W
W-------W------W---W
W-------WX-----W---W
W------------------W
W-------W----------W
W-------W------W---W
W-------W----------W
WW------WWW--------W
W------------------W
W------------------W
WWWWWWWWWWWWWWWWWWWW
