WWWWWWWWWWWWWWWWWWWW
W------------------W
W------------------W
W--------WWW-------W
W------------W-----W
W------------W-----W
W------------W-----W
W---W--------W-----W
W------------W-----W
W----W-------------W
WWW--WW------W-----W
W-----W------------W
WWW---W------------W
W-----W------------W
W-----W--W---------W
W-----W------------W
W------------------W
W-----------------XW
W----------WW------W
WWWWWWWWWWWWWWWWWWWW
