WWWWWWWWWWWWWWWWWWWW
W------------------W
W------------------W
W------------------W
W--------WWW-----WWW
W------------------W
W------------------W
W-----WWWW---------W
W-----WWW----------W
W--------------W---W
W-----W--------W--XW
W-----W---W----W---W
W--------------W---W
W-----W--------W---W
WWW------------W---W
WW-----------------W
WW---W--WW-W------WW
W----------W-------W
-------------------W
WWWWWWWWWWWWWWWWWWWW
