WWWWWWWWWWWWWWWWWWWW
W------------------W
W-----------------WW
W-----X-----W-W---WW
W---------------W-WW
W-W-----WW--W-----XW
W-----------W------W
W---------------W--W
W---------W--------W
W---------------W--W
W-W-W-----WWW-W-WW-W
W-W-------W--------W
W---------------WW-W
WWW-W-----------W--W
W---------W-----W--W
W---------------W--W
W---------W-----W--W
W------------------W
W------------------W
WWWWWWWWWWWWWWWWWWWW
