WWWWWWWWWWWWWWWWWWWW
W------------------W
W------------------W
W---------------W--W
W------------W-----W
W------------WW----W
W------------WW----W
W------------------W
W------------W-W--XW
W------------WWWW--W
W------------WWWWWWW
W------------------W
W------W--------WW-W
W---------------WW-W
W----W-----------W-W
WWW-------------WW-W
W---------------WWWW
W------------------W
W------------------W
WWWWWWWWWWWWWWWWWWWW
