WWWWWWWWWWWWWWWWWWWW
W------------------W
W---------------W--W
W------W----W---W--W
W----------------W-W
W-W----WWW--WWW----W
W-----------W------W
W-----------W------W
W-----------WW-----W
W-W----------------W
W-W-----W----------W
W-------W----------W
W-------W---------XW
WWWW---WW---W------W
W------W----W-----WW
W------W----W------W
W-----------W---WW-W
W------------------W
W------------------W
WWWWWWWWWWWWWWWWWWWW
