WWWWWWWWWWWWWWWWWWWW
W------------------W
W------------------W
W---------W-------XW
W------------X-----W
W---WWWW--W---W----W
W-----------------XW
W-------------W--X-W
W-------W-----W----W
W-------------W----W
W------------------W
W-----------------WW
W------W-----------W
W------W----------WW
W------W----------WW
W----------W-WW-W-WW
W------W--------W-WW
W------W-----------W
W-------------------
WWWWWWWWWWWWWWWWWWWW
