WWWWWWWWWWWWWWWWWWWW
W------------------W
W------------------W
W------------------W
W------------------W
W-W------W--------WW
W---WW-------------W
W--------WWWWWW--WWW
WW-----------------W
W---W-W------------W
W---W-------------WW
W-----WWW--------X-W
W------------------W
W-W-----------WW--WW
W-W---------------WW
W-W----W----------XW
W-----------------WW
------------------WW
W-----------W-------
WWWWWWWWWWWWWWWWWWWW
