WWWWWWWWWWWWWWWWWWWW
W------------------W
W------------------W
W----W------W------W
W----W--------W---WW
W------------------W
W----W-------------W
W-------------W----W
W------------------W
W-----W------------W
W------------------W
W---------------W--W
W---------W-----W--W
W---------------W--W
W---W-----------W--W
W------------------W
W---WW------------WW
W-X----------------W
W------------------W
WWWWWWWWWWWWWWWWWWWW
