WWWWWWWWWWWWWWWWWWWW
W------------------W
W------------------W
W-----WWWWWW------WW
W-----WW------WW---W
W-------------WW---W
W------------------W
W------------------W
WW-----W-----------W
WW-----------------W
W-----------------XW
WW-----------------W
W------------------W
W-W----------------W
W-W---------------WW
W------------------W
W------------------W
W------------------W
W------------------W
WWWWWWWWWWWWWWWWWWWW
