WWWWWWWWWWWWWWWWWWWW
W------------------W
W------------------W
W---------------W-WW
W--------------W---W
W--------------WWWWW
W-WW-----------W---W
W------------------W
WWWWW----------W---W
W------------------W
W-----W------------W
W-----------------WW
W-----------W------W
WW----WWW---------XW
W-------------W----W
WWWW----------W----W
W------------------W
W-----------------XW
W------------------W
WWWWWWWWWWWWWWWWWWWW
