WWWWWWWWWWWWWWWWWWWW
W------------------W
W------------------W
W------W-----------W
W------W-----------W
W------W-----------W
W-WW---W------X----W
W------------W----XW
W------WW----W-----W
W-WW----WWW--W-----W
W------------W-----W
W------------------W
W------------W----WW
W----W-------WW---WW
W-W---------------WW
W-WWWWW----------WWW
W-----------------WW
W-----------------XW
W------------------W
WWWWWWWWWWWWWWWWWWWW
