WWWWWWWWWWWWWWWWWWWW
W------------------W
W------------------W
W-------WWWWW------W
W------------------W
W------------------W
W------W-----WWW---W
WW-W----X--W-------W
W------------------W
W---W-----W--------W
W------W-----------W
W---W--------------W
W---W-------W------W
W------W----W------W
W---W--W----W------W
W-W-W-------W------W
W---------------W--W
W-W-------------W--W
W------------------W
WWWWWWWWWWWWWWWWWWWW
