WWWWWWWWWWWWWWWWWWWW
W------------------W
W-------------------
W------------------W
W------------------W
W------------------W
W-----------------WW
W------------W-WW-WW
WW-----------------W
W-----------------WW
W---------W--------W
W------------W-----W
W------------------W
W------------W-----W
WW-----W---W-WW----W
W----------------XXW
W----------------W-W
W------------------W
W------------------W
WWWWWWWWWWWWWWWWWWWW
