WWWWWWWWWWWWWWWWWWWW
W------------------W
W------------------W
W--------WWW------XW
W-------WW-W------WW
W-W-W--------------W
W----------WWW-----W
W-----W-----------XW
W-WWW-W------------W
W--------------W---W
W------------------W
W-------W-------WW-W
W------------------W
W---------W--------W
W------------------W
W-W----------------W
W--W----------W----W
W------------------W
------------------XW
WWWWWWWWWWWWWWWWWWWW
