WWWWWWWWWWWWWWWWWWWW
W------------------W
W----------W-------W
W----------W-------W
W-----------------XW
W-W----------------W
W-------W---W------W
W-W---W-W----------W
W------------------W
WWW---WWWWW-----WWWW
W------------------W
W------------------W
W------------------W
W----------------WWW
W------------------W
W------------------W
WW----------------WW
W------------------W
W------------------W
WWWWWWWWWWWWWWWWWWWW
