WWWWWWWWWWWWWWWWWWWW
W------------------W
W---------W--------W
W------------------W
W--------------WW-WW
W-W----------------W
W-W----------------W
W--------W--------WW
W-----------------WW
W------------------W
W---------W--------W
W--------X---------W
W-----WW--W--------W
WW-----------------W
WW-----------------W
W-----W-----------XW
W-----W----------WXW
W------------------W
W------------------W
WWWWWWWWWWWWWWWWWWWW
