WWWWWWWWWWWWWWWWWWWW
W-----------------WW
W--------W---------W
W--------WWW-------W
W--------W--------WW
W--W-----X--------WW
W--WW----W---------W
W--W-------W-------W
W---W--------------W
W-------------W----W
W-------------W---XW
W------------------W
W------------------W
W------------------W
W------------------W
WWWWW-----W--------W
W------------------W
W------------------W
W------------------W
WWWWWWWWWWWWWWWWWWWW
