WWWWWWWWWWWWWWWWWWWW
W----------W-------W
W----------W-------W
W----------W---W--WW
W------------------W
WW----------------XW
WWWWW--W-----------W
W------------------W
W------------------W
W---------W--------W
W---WW----WW-----WWW
W----------------WWW
W---W------W-------W
W---------W--------W
W-------W----------W
W--W---------------W
W--W---------------W
W------------------W
W-------------------
WWWWWWWWWWWWWWWWWWWW
