WWWWWWWWWWWWWWWWWWWW
W------------------W
W------------------W
W------------------W
W------------------W
W------------W-----W
W-WW-------W------XW
W------------------W
W-----W-----X--W---W
W-----W------------W
WWW---W-----------WW
W--------------W--WW
WWWW--------------WW
W------------------W
WW----------------WW
W------------------W
W------------------W
W------------------W
W------------------W
WWWWWWWWWWWWWWWWWWWW
