WWWWWWWWWWWWWWWWWWWW
W------------------W
W------------------W
W------------W-----W
W------W-----W-----W
W---------------W-WW
W--------W-W------WW
W------------------W
W-----------------WW
W---X-------------WW
W---------WWW------W
W------------------W
W------------------W
W-W----------------W
W-----X------W----WW
W-------W---------WW
W-WW----W--WW------W
W-------W----------W
W------------------W
WWWWWWWWWWWWWWWWWWWW
