WWWWWWWWWWWWWWWWWWWW
W------------------W
W------------------W
W----W-WWW---------W
W------------------W
WWW------W---------W
W--------W---------W
W--------WWWW------W
W-------WW---------W
W------------------W
W-------W---------XW
W-------WW---------W
W-------W----------W
W--W----W--W-------W
W--W---------------W
W--W----W----W-----W
W------------------W
W------------------W
W------------------W
WWWWWWWWWWWWWWWWWWWW
