WWWWWWWWWWWWWWWWWWWW
W------------------W
W------------------W
W------------------W
W------------------W
W------------------W
W--------W---------W
W------------------W
W------------------W
W-WW-W--W---------XW
W----W--W-------X--W
W----W-------------W
W----W--W----------W
W----W-------------W
W--------------W-WWW
W--------------W---W
W-----------W--W---W
W-----------W------W
W------------------W
WWWWWWWWWWWWWWWWWWWW
