WWWWWWWWWWWWWWWWWWWW
W------------------W
W------------------W
W-----------------WW
W---------W--W---WWW
W---------W-------XW
W---------W------WWW
W---------W--------W
W---------W-------WW
W---------W--W----WW
W-------WWWWWWW----W
W------------W-W---W
W--W-------------X-W
W--W---------------W
W--W---------------W
W--W-W-W------XW---W
W--W--WWW-W--------W
W------------------W
W------------------W
WWWWWWWWWWWWWWWWWWWW
