WWWWWWWWWWWWWWWWWWWW
W------------------W
W------------------W
W------------------W
W-----W------------W
W---------------WWWW
W-----W------------W
W----------X------WW
W----------W---WW-WW
W------------------W
W------------------W
W-----------------WW
W-W---------------XW
W-----------------WW
W---------W--------W
W----W-------------W
W-----W------------W
W-----W------------W
W-------------------
WWWWWWWWWWWWWWWWWWWW
