WWWWWWWWWWWWWWWWWWWW
W------------------W
W------------------W
W------------------W
W--------W---------W
W--------W---------W
W--------W---------W
W--------WW-W----WWW
W--------W--------WW
W------------------W
W-W-W--------------W
W-------W----------W
W-----------------XW
W------------------W
W---------WWWWW----W
W------WW---------WW
W---W--------------W
W------------------W
W------------------W
WWWWWWWWWWWWWWWWWWWW
