WWWWWWWWWWWWWWWWWWWW
W------------------W
W------------------W
W------------W-WWWWW
W------------W-W---W
W------------W-----W
W--W---------W-----W
WWWWW--------W-----W
W--X---------------W
W--WW--------W-W--WW
W--WWW-W--W--WWWWWWW
W------W--W--------W
W--WW--W-----------W
W------W--W--------W
W------------------W
W---------X--------W
W-------W----------W
W------------------W
W------------------W
WWWWWWWWWWWWWWWWWWWW
