WWWWWWWWWWWWWWWWWWWW
W------------------W
W------------------W
W------------------W
W------W----------WW
W-WWW--------------W
W----------------W-W
W----------------WWW
W------------------W
W------------------W
W---------W--------W
W---------W-WW----WW
W------------------W
W---W--------------W
W------------------W
W----W-----------XWW
W----W-------------W
W-----------------WW
W------------------W
WWWWWWWWWWWWWWWWWWWW
