WWWWWWWWWWWWWWWWWWWW
W--------W---------W
W--------W---------W
W------------------W
W-------W----------W
WW------W-------W-XW
W-------W----------W
W------------------W
W--W-WW------------W
W-------------W----W
W------------------W
W----W--XWWWW-W----W
W----W------W-W----W
W------------------W
W------------------W
W---------W--------W
W------------------W
W--------W---------W
W------------------W
WWWWWWWWWWWWWWWWWWWW
