WWWWWWWWWWWWWWWWWWWW
W-----------------WW
W------------------W
W-----------------WW
W-------W----W-----W
W------------------W
W------------------W
WWW-W-W------------W
W-----W------------W
WW--W-W------------W
W---W-WW-WW-----WW-W
W---W-----------WW-W
W------------------W
W---W--W-W---------W
W---W----W--------WW
W--WW----WWWWWWW---W
W--W---------------W
W--W--------------XW
W--------------W---W
WWWWWWWWWWWWWWWWWWWW
