WWWWWWWWWWWWWWWWWWWW
W------------------W
W--------------W---W
W--------------W---W
W------------------W
W------------------W
W-WWWWW------------W
W----W----WWW-----XW
W-W--W---------W---W
W------------------W
W----W---W---------W
W----WW-----------WW
W------------------W
W------------------W
W-------W---------WW
W-------W----------W
W-------W----------W
W-----------------WW
W------------------W
WWWWWWWWWWWWWWWWWWWW
