WWWWWWWWWWWWWWWWWWWW
W------W-----------W
W------W-----------W
W------W-----------W
W------W----W------W
W------W-----------W
W------------------W
W------------------W
W---------W--------W
W---------W---W--W-W
W------------------W
W---------W--------W
W---------W--------W
W---------W--------W
WW-------WW-WWW-W--W
W------------------W
W-----X--W----WWW-WW
W------------------W
W------------------W
WWWWWWWWWWWWWWWWWWWW
