WWWWWWWWWWWWWWWWWWWW
W------------------W
W------------------W
W-----W-W----------W
W------------------W
W-W------X---------W
W-----------------XW
W------------------W
WWW----------------W
W------------------W
W---------W------W-W
W----W----WW-------W
W-W----------------W
W------------------W
W-W--------W-W-----W
W------------W-----W
W-W----------------W
W------------------W
W------------------W
WWWWWWWWWWWWWWWWWWWW
