WWWWWWWWWWWWWWWWWWWW
W------------------W
W------------------W
W------W--W--------W
W------------------W
W------------------W
W----------W-------W
W------------W-----W
W------------W---W-W
W------------------W
W----------------WWW
WW-----------------W
W--------W---WW----W
WW-------W---------W
W--------W--------WW
WW-------W-----W---W
W--------------W---W
W---W-------------XW
W------------------W
WWWWWWWWWWWWWWWWWWWW
