WWWWWWWWWWWWWWWWWWWW
W-----------W------W
W------------------W
W-----------W------W
W----W---------WW-WW
W----W-------------W
WWW--W----------WWWW
W------------------W
W-X----------WW-WW-W
W-------------W----W
W-------------WWWWWW
W--------------W----
W--------------WW-WW
W-------------------
W--------------WW-WW
W-WWWW----------W-WW
W-----X------------W
W--W--WWW--------WWW
W--W--WWWW---------W
WWWWWWWWWWWWWWWWWWWW
