WWWWWWWWWWWWWWWWWWWW
W------------------W
W------------------W
W--------WWWW-----XW
W------------------W
W------------------W
W------------------W
W--------WW--------W
W--------W---------W
W---W-------------XW
W--------W-----WWW-W
W--------W---------W
WW-----------------X
W--------------WWWWW
W-------W--W----W-WW
W------------------W
W-----------WW-WWWWW
W-----------W------W
W------------------W
WWWWWWWWWWWWWWWWWWWW
