WWWWWWWWWWWWWWWWWWWW
W------------------W
W------------------W
W-------W---------XW
W-------------W----W
W-W----------------W
W-W----------------W
WWW----------------W
W-----------W------W
W-----------------XW
W-WW------------X--W
W-WW-------WWW-----W
W-WW--------------XW
W-WW--------------WW
W-WW------W--W-----W
W-W----------WW----W
W-------W----WW----W
W-------W---------XW
W------------------W
WWWWWWWWWWWWWWWWWWWW
