WWWWWWWWWWWWWWWWWWWW
W-----------------WW
W--------------W---W
W------W-------W---W
W------W-WW----W---W
W------W-----------W
W------W----------WW
W------W-----W--WWXW
W-W----W--------WWWW
W-W----W-----W-----W
W-W----------W-----W
W-W----W-----W-----W
W-W---------W------W
W-----------WWWWW--W
WWW----------------W
W-----------W------W
W-----------------WW
W------------------W
W------------------W
WWWWWWWWWWWWWWWWWWWW
