WWWWWWWWWWWWWWWWWWWW
W------------------W
W------------------W
W----------------WWW
W------------------W
W---W--------------W
W---W-----W--------W
W---W-------------WW
W---W-----W--------W
W---W-----W--W----XW
W---------W--WWWWWWW
W---------WWWW-W--WW
W---------W--------W
W---------W-----WWWW
W---------WWWWW----W
W-WW---------------W
W------------------W
W------------------W
W------------------W
WWWWWWWWWWWWWWWWWWWW
