WWWWWWWWWWWWWWWWWWWW
W------------------W
W------------------W
W---------------W--W
W---------------W--W
W------------------W
W---------------W--W
W------------------W
W------------------W
W----------X-------W
W------------------W
WWW-----------W---WW
W-------W---WWW----W
W-------W-W--W--WWWW
W-------W----------W
W-------WWWWWW------
W-------WW---------W
W------------------W
W-------------------
WWWWWWWWWWWWWWWWWWWW
