WWWWWWWWWWWWWWWWWWWW
W------------------W
W------------------W
W------------W-----W
W------------------W
WW---W-W-----------W
WW-----------------W
W--------------W--WW
W------------------W
W--------------W--XW
W------W-----------W
WW-------------W---W
W-W------------W---W
W------------------W
W---------------W--W
WWW-----W------WW-WW
W-------W---------WW
W-------W--X-------W
W------------------W
WWWWWWWWWWWWWWWWWWWW
