WWWWWWWWWWWWWWWWWWWW
W------------------W
W------------------W
W------------------W
W------------------W
W--------W---------W
W--WW--------------W
WW-----------------W
WW--------W--------W
WW--------W--------W
WW------------W----W
WW-----------------W
WWW----------------W
WX----------------WW
WWW-W--------------W
W------------------W
W------------------W
W------W-----------W
W------------------W
WWWWWWWWWWWWWWWWWWWW
