WWWWWWWWWWWWWWWWWWWW
W------------------W
W------------------W
W------------------W
W----WW------------W
W-W----------------W
W-W---W---W--------W
W-W----------------W
W-----W------------W
W-----W------------W
W--W-WW------------W
W--W-------------XWW
W----WWWW----------W
W-W---------------WW
W------WWWWWW------W
WWW----WW----------W
W------W-----------W
W------------------W
W------------------W
WWWWWWWWWWWWWWWWWWWW
