WWWWWWWWWWWWWWWWWWWW
W------------------W
-------------------W
W---------X--------W
W------W-----------W
W------------------W
W-W----W---W-------W
W----------W-------W
W----------W----WWWW
W-W--------W-----W-W
W----------W-----W-W
W----------W-W---WXW
W----------W-----WWW
W----------------W-W
WW---------------XXW
WWW-W--------WWWWWWW
W---W-WWWW----W----W
W-----------------XW
W------------------W
WWWWWWWWWWWWWWWWWWWW
