WWWWWWWWWWWWWWWWWWWW
W------------------W
W------------------W
W-------------X----W
W-------W----WW----W
W------------------W
WWWWW----W---------W
WW-----------------W
W------------------W
W------------------W
W------------------W
W--------WW-------WW
W------------------W
WWW-W--------------W
W---W------------W-W
W--------------W---W
W--------------W---W
W--------------W---W
W------------------W
WWWWWWWWWWWWWWWWWWWW
