WWWWWWWWWWWWWWWWWWWW
W------------------W
W------------------W
W------------------W
W------------------W
W-W----------------W
W------------------W
W-------------W-WX-W
W-WWWWW-----------WW
WWW-------W---WWW-WW
W------------------W
W------------------W
W--W-----------W---W
W---------W-------XW
W--------------WWWWW
W------------------W
W----------------W-W
W------------------W
W------------------W
WWWWWWWWWWWWWWWWWWWW
