WWWWWWWWWWWWWWWWWWWW
W---------W--------W
W---------W--------W
W-----W---W--------W
W-----W---W-W-W----W
W--W--------------WW
W--W--------W------W
W-----W------------W
W------------------W
W------------------W
W------------W-----W
W---WWWW-----W-----W
W------------W----XW
W------WW----------W
W--WWW-------W-----W
WW----------------WW
W-------W---------XW
W---W---W----------W
W-----------------WW
WWWWWWWWWWWWWWWWWWWW
