WWWWWWWWWWWWWWWWWWWW
W------------------W
W------------------W
W------------------W
W------------------W
W------------------W
W-------------W----W
W--WW-------W-W----W
W-----------W------W
W------------------W
W-W-W-W---W--------W
W-W---------------WW
W-W----------------W
W-W-------WWWWW----W
WWW----------------W
W-W----------------W
W-W-WWW-----------XW
W------------------W
W------------------W
WWWWWWWWWWWWWWWWWWWW
