WWWWWWWWWWWWWWWWWWWW
W------------------W
W------------------W
W---------W--------W
W---------W--W--WW-W
W-W-------W--------W
W------------------W
W-W-W------------W-W
W-W-W--------------W
W-----------------WW
W---W-----W--X-----W
W-----W---W-W-W----W
W-----W---W--------W
WW-----------------W
W-----------------XW
W------------------W
W-----------------WW
WW-----------------W
W------------------W
WWWWWWWWWWWWWWWWWWWW
