WWWWWWWWWWWWWWWWWWWW
W------------------W
W------------------W
W-----------------WW
W-----------------WW
W-W------WWW------WW
W-W----------------W
W-W---------------XW
W-W----------------W
W-W----------W-----W
W-W----------------W
W-W----W-----------W
WWW----W-----X-----W
WW--W---------W--W-W
WW--W---------W----W
WW--W--------------W
W---WWWW--W--------W
W---W--------------W
W------------------W
WWWWWWWWWWWWWWWWWWWW
