WWWWWWWWWWWWWWWWWWWW
W---------------W--W
W---------------W--W
W---------------W--W
W---------------W--W
W------------------W
W------------------W
W------------------W
W------------------W
WW-----------------W
WWWWWWW------------W
W-------------W----W
WWW---W-------W----W
WWW---------------XW
W-----W--------WWWWW
W--------------W---W
W-----W----W-------W
W------------------W
W------------------W
WWWWWWWWWWWWWWWWWWWW
