WWWWWWWWWWWWWWWWWWWW
W------------------W
W------------------W
W------------------W
W-----------------WW
W-------------W----W
W---W------W-------W
W----------W-------W
W------------------W
W-W-----W--W-------W
W-----------------WW
W----WWWW----------W
W----W------------XW
W-W--W------------WW
W-----------------WW
W-----------------WW
W-----------------WW
W------------------W
W------W-----------W
WWWWWWWWWWWWWWWWWWWW
