WWWWWWWWWWWWWWWWWWWW
W------------------W
W------------------W
W------------------W
W-----------------WW
W---W----W---------W
W------------------W
W-WWWW-------------W
W------------------W
W------------------W
W--W---------------W
W--WXWW--W---------W
W--W---------------W
W-WW--------W------W
W--------W--W------W
W-W------W--W--W---W
W-W---------W------W
W-----------W--W--XW
W------------------W
WWWWWWWWWWWWWWWWWWWW
