WWWWWWWWWWWWWWWWWWWW
W------------------W
W------------------W
W-------W----------W
W-------W----------W
W------------------W
W--W---------------W
W------------------W
W---------WWWWW----W
W------------------W
W------------------W
W----------W-------W
W-------W----------W
W-------WWWW------XW
W-------W----------W
W-------W-WWWW-----W
W-------W----------W
W-----------WW-----W
W------------------W
WWWWWWWWWWWWWWWWWWWW
