WWWWWWWWWWWWWWWWWWWW
W------------------W
W------------------W
W---------------WWWW
W--------W-----WWWWW
W--------W-----W---W
W--------------W---W
W--WW-W--------W---W
W-----W--------W---W
W--------------W--XW
WW------WW---------W
W-W--WW-W----------W
W-W----------------W
W-W-------W------W-W
W-W----------------W
W-W-------W--------W
W---------W--------W
W------------------W
W----------------WWW
WWWWWWWWWWWWWWWWWWWW
