WWWWWWWWWWWWWWWWWWWW
W-----------------WW
W------------------W
W-----------------WW
W------------------W
W------------------W
W-----WW----------WW
WW--------------W--W
WWWW---------------W
W------------------W
W------------WW----W
W------------WW----W
W------------W-----W
W------------W-----W
W-----W------------W
W------------------W
W-----WWW--W-------W
W-----------------XW
W------------------W
WWWWWWWWWWWWWWWWWWWW
