WWWWWWWWWWWWWWWWWWWW
W------------------W
W-------------W----W
W-------W-W---W--XWW
W-------W-----W---WW
W--W----W-----WWWWWW
W--W----W---------XW
W-------W-----WW--WW
W------------W-W---W
W------------------W
W--------W--W-----WW
W-----------WW-W-WWW
W-------------W---XW
W----WW--W----W--WWW
W-------------W----W
W------------------W
W----------------WWW
W------------------W
W------------------W
WWWWWWWWWWWWWWWWWWWW
