WWWWWWWWWWWWWWWWWWWW
W------------------W
W------------------W
W------------------W
W----WW-------W-WWWW
W-----------------WW
WW-----------------W
W-WW-W-----WW------W
W------------------W
W------------------W
W-WWW-----W--------W
W---------------W--W
W-W-----W----------W
W--------------W---W
W---------------W--W
W-------WWW-------WW
W------------------W
W-----X------------W
W------------------W
WWWWWWWWWWWWWWWWWWWW
