WWWWWWWWWWWWWWWWWWWW
W------------------W
W------------------W
W----W--W------W--WW
W--------------WW-WW
W-W-WWWWW--W------WW
W----WW------X----WW
W----W-------------W
W----W-----W------WW
W----W------------WW
WWW--W-WW----------W
W------------------W
W------------------W
W-W----------------W
W----------W-------W
W-W----------------W
W------------------W
W-W------W-WW------W
W------------------W
WWWWWWWWWWWWWWWWWWWW
