WWWWWWWWWWWWWWWWWWWW
W------------------W
W------------------W
W--------WW-W------W
W-------W---W--W---W
W-W-WWW------------W
WWW---------W-WW---W
W-----------WWWWW--W
WW----W--------W---W
W----------W------XW
WW-W--W----W---WW--W
W-----W------------W
WW-----------------W
W-----------------WW
W-----------------WW
W----WW-----------WW
W----WW------------W
W----W-------------W
W-----------------XW
WWWWWWWWWWWWWWWWWWWW
