WWWWWWWWWWWWWWWWWWWW
W------------------W
W------------------W
W------------------W
W------W-WW-------WW
W-W----W-----------W
W-----------W------W
WWW---W------------W
W-----WW-----------W
W------------------W
W-----------W------W
W------------------W
W-----------------XW
WW-W---------------W
W---------WWW------W
W--------------W---W
W--------------W---W
W------------------W
W-------------------
WWWWWWWWWWWWWWWWWWWW
