WWWWWWWWWWWWWWWWWWWW
W----------W-------W
W----------W-------W
W----W-----W-------W
W----------W------XW
W------------------W
W--WWW-------------W
W-----------W-W--WWW
W-------------W----W
W-------------W----W
W-------------WW---W
W--------W--------WW
W--------W-----W--WW
W--------W-----W---W
W-------WWWW-------W
W--------W---------W
W--------------W---W
W------------------W
W------------------W
WWWWWWWWWWWWWWWWWWWW
