WWWWWWWWWWWWWWWWWWWW
W------------------W
W------------------W
W-------------------
W------------------W
W--------W---------W
W-------XW--W------W
WWWW---------------W
W--------W-----W--WW
W-WW---------------W
WW---------------W-W
W-------------WWWW-W
W------------------W
WWW----------------W
W------------------W
W------W-----------W
W-W----------------W
W------------------W
W------------------W
WWWWWWWWWWWWWWWWWWWW
