WWWWWWWWWWWWWWWWWWWW
W------------------W
W------------------W
W-------X----------W
W------------------W
W------------------W
W-------------WWWWWW
W-----W-----------WW
W-----W-----------WW
W------------------W
W-----------W------W
W------------------W
W------------------W
W------------------W
W------------------W
W---W--------------W
W---W--------------W
W------------------W
W------------------X
WWWWWWWWWWWWWWWWWWWW
