WWWWWWWWWWWWWWWWWWWW
W------------------W
W------------------W
W------W---X----W-WW
W------W--------W--W
W-W----W--------W--W
W-W----W-WW-----WWWW
W-W-------W-------XW
W-----------W---WWWW
W-----------W------W
W-W-W-----WWW------W
W---------------W--W
W------------------W
W----WW-----------XW
W----W------------WW
W----W----WW-------W
W------------------W
W------------------W
W------------------W
WWWWWWWWWWWWWWWWWWWW
