WWWWWWWWWWWWWWWWWWWW
W------------------W
W------------------W
W------------------W
W------------------W
W-W-----------W----W
W-----------------XW
W------------------W
W----W-------------W
WW-----------------W
W---WWWW-----------W
W----W-----------XXW
W------------W--WW-W
W------------------W
W------------W----XW
WWWWW--------------W
W------------W-----W
W------------------W
W-----------------XW
WWWWWWWWWWWWWWWWWWWW
