WWWWWWWWWWWWWWWWWWWW
W------------------W
W-------W----------W
W-------W----------W
W------------------W
W-------------W----W
W------------------W
WW--WW--------W----W
WW--WW---------W---W
W---WW------------XW
W----------WWW-WWWWW
W---W-------------XW
W----W-------------W
W----W-------------W
W----W--------WWWWXW
W-----------------WW
W----W----WW------WW
W-----------------WW
W------------------W
WWWWWWWWWWWWWWWWWWWW
