WWWWWWWWWWWWWWWWWWWW
W------------------W
W------------------W
W--------------W---W
W------------------W
W----------------XWW
W-W-----W----------W
W------------------W
W-----------W------W
W--W----------WWW--W
W-----------W--WWWWW
W-----------WW-----W
W-----------W------W
W-----------W------W
W-----------WWWWWW-W
W-----------W--WWW-W
W-----------W----W-W
W------------------W
W------------------W
WWWWWWWWWWWWWWWWWWWW
