WWWWWWWWWWWWWWWWWWWW
W------------------W
W------------------W
W-----------------WW
W------------------W
W--------------X---W
W----------W--W----W
W--W--------W-W----W
W-WW---------------W
W--W---------------W
W-------W-------W--W
W--WWWWWW----------W
W--W---------------W
W---------------W--W
W------W--------W--W
W---------------W--W
W------W--------W--W
W------------------W
W------------------W
WWWWWWWWWWWWWWWWWWWW
