WWWWWWWWWWWWWWWWWWWW
W------------------W
W------------------W
W------W-----------W
W------WW----------W
W----W-WW----W-----W
W-----------------WW
W-W----------------W
W----------W-------W
W-------------W----W
WW---------WWWW----W
W-----------------WW
W-------WWWW--W----W
W-------------W----W
W------------------W
W--------W--X---W--W
WWWW---------------W
W------------------W
W------------------W
WWWWWWWWWWWWWWWWWWWW
