WWWWWWWWWWWWWWWWWWWW
W------------------W
W------------------W
W----WWWWWWWWW-----W
W----W-------------W
WW---W-------------W
W----W---W---------W
W----W----W---W----W
W---------WWW------W
W----WW------------W
W------------------W
W-----------------WW
W-WWW---------W----W
W-------------W----W
W-----------------WW
W-------------W---WW
W-------WWW---W---WW
W------------------W
W-----------------XW
WWWWWWWWWWWWWWWWWWWW
