WWWWWWWWWWWWWWWWWWWW
W----------W-------W
W----------W-------W
W-----W----W------WW
W----WW-W--W-------W
W------------------W
W----------X-------W
W-------WW---------W
W-W--W---W-W-W----WW
W------------W--WWWW
W------------------W
W-----W--W---------W
W-----W------------W
W------------------W
W---WWWW-W-W-W-----W
W------------------W
W----W-------------W
W------------------W
W------------------W
WWWWWWWWWWWWWWWWWWWW
