WWWWWWWWWWWWWWWWWWWW
W------------------W
W------------W----WW
W------------W----WW
W--------W---W-----W
W------------W----WW
WWWW--------W------W
WWW----W----W-----XW
W------W------WWWWWW
WWW----------------W
W-------------W----W
W-------------W----W
W----WW-WW---------W
W----------------W-W
W------WW---WW--WW-W
WWW---------W----W-W
W-W---------W----W-W
W----------------W-W
W------------------W
WWWWWWWWWWWWWWWWWWWW
