WWWWWWWWWWWWWWWWWWWW
W------------------W
W-------------------
W-------------W----W
W-------------WWWW-W
W---W--------------W
W---W--------------W
W----------------W-W
W------------------W
W-W-W---W----------W
W---------WW-------W
WWWW---------------W
W------------------W
W------WWW---------W
W------W---------WWW
W------W----------WW
WWWW---W-----------W
W-----------------XW
WW-----WWW---------W
WWWWWWWWWWWWWWWWWWWW
