WWWWWWWWWWWWWWWWWWWW
W-------------------
W------------------W
W-----------W-----WW
W-----------------WW
W-------WW--------WW
W-------W---------XW
W-W-WW-WW----------W
WWW------------X---W
W------------------W
W------------------W
W------------------W
W------------------W
W------------------W
W--------------W---W
W--------------W---W
W------------------W
W------------------W
W------------------W
WWWWWWWWWWWWWWWWWWWW
