WWWWWWWWWWWWWWWWWWWW
W------------------W
W------------------W
W-----W------------W
W------------------W
W------------------W
W-W---------------WW
W-----------------WW
W-----------------WW
W-W---------------WW
W----------W-W-WW--W
W-----X------------W
WW-WWWW-W----------W
W------------------W
W------------------W
W------------------W
W---W------W-------W
W----------W-------W
W------------------W
WWWWWWWWWWWWWWWWWWWW
