WWWWWWWWWWWWWWWWWWWW
W------------------W
W-------------W----W
W-------------W----W
W------W-----------W
W--WWW-WW-----W--X-W
W-------------W----W
W------------------W
W--WWW--WWWW-----X-W
W--W----------WWWW-W
W--WWWW-----WWW--W-W
W--W-------------WWW
W----------------W-W
W--WWWW-X--------W-W
W----W----------WWWW
W------W--------W--W
W---WWWW------W-W--W
W------------------W
W------------------W
WWWWWWWWWWWWWWWWWWWW
