WWWWWWWWWWWWWWWWWWWW
W------------------W
W------------------W
W------------------W
W----W-------------W
W----W----------WWWW
W------------------W
W----W-W----------XW
W---------------WWWW
W------------------W
W--------WW--------W
W-----------WW-----W
W-----WWWWW--------W
W------------------W
W---------W--------W
W------------------W
W------------------W
W-------------W---WW
W------------------W
WWWWWWWWWWWWWWWWWWWW
