WWWWWWWWWWWWWWWWWWWW
W------------------W
W-----W------------W
W-----WW-WWW-------W
W------------------W
W-----W------------W
W-W---W-----------WW
W------------------W
W------------------W
W------------------W
W--W---------------W
W--W---------------W
W------------------W
W------------------W
W----------------W-W
W------------------W
WW-----------------W
W-----------------XW
W-----------------WW
WWWWWWWWWWWWWWWWWWWW
