WWWWWWWWWWWWWWWWWWWW
W--------W---------W
W--------W---------W
W-----------------XW
W------------------W
W---------W--------W
W---WW----W--------W
W--WW--------------W
W-----------W------W
W--------------W---W
WW-----------------W
W------W-WW-----W--W
WW--------------WWWW
WW---------WW-----WW
W----------WWWWWW--W
W------------------W
WW-----------------W
W------------------W
W------------------W
WWWWWWWWWWWWWWWWWWWW
