WWWWWWWWWWWWWWWWWWWW
W------------------W
W------------------W
W------W-----------W
W------------------W
W---------WW-------W
W---------W------W-W
WW---WWW---------W-W
W----W-------------W
W-----------------WW
W-----------------WW
W-----W------------W
W------------------W
W------------------W
W------------------W
W----------X-------W
W-----------------XW
W------------------W
W------------------W
WWWWWWWWWWWWWWWWWWWW
