WWWWWWWWWWWWWWWWWWWW
W------------------W
W------------------W
W----W--W----------W
W----------------X-W
W------------------W
W---W---W----------W
W-----------------WW
W-------W---------WW
W----W------------WW
WW---W------W-----WW
W-------W----------W
WWWWWW-------------W
W-------------W---WW
W------------------W
W------------------W
W-----------------WW
W------------------W
W-----------W-WW---W
WWWWWWWWWWWWWWWWWWWW
