WWWWWWWWWWWWWWWWWWWW
W-------------------
W------------------W
W-------W------WW--W
W-------W------WW--W
WWWWW-----W--------W
W------W--W--------W
WWWWWW-W-----------W
W------------------W
W------------------W
W------------------W
W------------------W
W------------------W
W-----------------XW
W-----------W-WWW-WW
WWW---------W-----WW
W------------------W
W------------------W
W------------------W
WWWWWWWWWWWWWWWWWWWW
