WWWWWWWWWWWWWWWWWWWW
W------------------W
W------------------W
W-----------------WW
W-----------------WW
W------------------W
W-------------W---WW
W----W-WWWW---W---WW
W-------------W----W
W----W-W-----------W
W----W-------------W
W-----------------WW
W-------------W---XW
W------------------W
W-------------W----W
WW------------W----W
W----WW-------W----W
W-------------W---XW
W------------------W
WWWWWWWWWWWWWWWWWWWW
