WWWWWWWWWWWWWWWWWWWW
W-----------------WW
W------------------W
W-----------------WW
W------------------W
W------------------W
W------------------W
W------------------W
W----W----------W-WW
WWW----------------W
W------------------W
W-------------W-W--W
W------------------W
WW-----------------W
WW----------------XW
WW-------WW-----W--W
W--------W---------W
W------------------W
W------------------W
WWWWWWWWWWWWWWWWWWWW
