WWWWWWWWWWWWWWWWWWWW
W------------------W
W------------------W
W---------W--------W
W---------W-------XW
W--WW-----W--------W
W---W--------------W
W---W--------------W
W---W------WWWWW-X-W
W------------------W
W------------------W
WWW-W-------------WW
W-------WW---W----WW
W------------W-----W
W------------W-W---W
WW------W----W-----W
WW--W---W----------W
WW-----------W-----W
W-------------------
WWWWWWWWWWWWWWWWWWWW
