WWWWWWWWWWWWWWWWWWWW
W------------------W
W------------------W
W-----WWWW---------W
W------------------W
W-W----------------W
W------------------W
W-----------W-----XW
W------------------W
W------------------W
WWW---------------WW
W------WW----------W
W----------W-------W
W------------------W
W------W--------W--W
W-------W----W-WWWWW
W-------W-------W-WW
W------------------W
W------------------W
WWWWWWWWWWWWWWWWWWWW
