WWWWWWWWWWWWWWWWWWWW
W------------------W
W-----------------WW
W------W-----------W
W------------------W
W---------------W--W
W--W--W----W-WW-W--W
W--WWWW------------W
W--W---W-----------W
W--W---------------W
W--W---------------W
W--W---------------W
W------------W-----W
W---W-WW-----------W
W------------WWWWW-W
W------------------W
W------------------W
W-----------------XW
W------------------W
WWWWWWWWWWWWWWWWWWWW
