WWWWWWWWWWWWWWWWWWWW
W------------------W
W------------------W
W------------WW-W--W
W------------------W
W------------------W
W-----------------XW
W-----------------WW
W----W-------------W
W----W-------------W
W----W-WW-WWW------W
W----W-------------W
W----W--W----------W
W----W-------------W
W---------------WWWW
W--W----W---------WW
W--W---------------W
W--W---------------W
W------------------W
WWWWWWWWWWWWWWWWWWWW
