WWWWWWWWWWWWWWWWWWWW
W------------------W
W------------------W
W---------------W--W
W---------------W-WW
W---------------W--W
W---------------W-WW
W------------W--W--W
W------------W--W--W
WWWW---------W--W-WW
W--W---------W-----W
W--W---------W--W--W
W------W-----W-----W
W------------------W
W-------X----X-----W
W------------------W
W-----------------WW
W-----------------XW
W-----------------WW
WWWWWWWWWWWWWWWWWWWW
