WWWWWWWWWWWWWWWWWWWW
W------------------W
W------------------W
W------------------W
W------------------W
W------------------W
W-----W------WW-WWWW
W-----WW-----------W
W------------------W
W------W-----W--W--W
W------------------W
W------W----------WW
W-W--------W----W--W
W------------------W
WW-----------------W
W------------------W
W-W--------W------XW
W--------------WW--W
W------------------W
WWWWWWWWWWWWWWWWWWWW
