WWWWWWWWWWWWWWWWWWWW
W------------------W
W------------------W
W------------------W
W-------W----------W
W-------W----------W
WWW-----W---------WW
W------------------W
W------------------W
W----------------WWW
W-----WWWWWWWW-----W
WW-----------------W
W--W-------------WXW
W--W-----------W-WWW
W--W-----------WW--W
W-----------------XW
W---------------WWWW
W------------------W
W------------------W
WWWWWWWWWWWWWWWWWWWW
