WWWWWWWWWWWWWWWWWWWW
W------------------W
W------------------W
W------------WWWW-WW
W-------WWWWW-----WW
W--W-------------WWW
W------------------W
W--WW--------------W
W--WW----W---------W
W--------W---------W
WW--W----W---------W
W---W---WW---------W
WW--W-------------XW
W---W--------------W
W-----------XW-----W
W------------------W
W---W--------------W
W------------------W
W------------------W
WWWWWWWWWWWWWWWWWWWW
