WWWWWWWWWWWWWWWWWWWW
W------------------W
W------------------W
W------------------W
W-----------------WW
W-W----------------W
W----XW--W-W----WWWW
W-W----------------W
W------------------W
W-----W----W-------W
W-W-------------W--W
W-----------------WW
W----W-------------W
W------------------W
W---------WWWWWWWW-W
W---------W--------W
W---------W-------XW
W------------------W
WW---------------XWW
WWWWWWWWWWWWWWWWWWWW
