WWWWWWWWWWWWWWWWWWWW
W------------W-----W
W------------W-----W
W------------W-----W
W---------WW-W---X-W
W------W-----------W
W-----WW---------X-W
W---------------W-WW
W------------------W
W---------W-------XW
WWW-------W--------W
W---------W--------W
W-WW-W----WW-X-----W
W----------W-WWWW-XW
W----------W----W--W
W------------------W
W-----------W------W
W------------------W
W------------------W
WWWWWWWWWWWWWWWWWWWW
