WWWWWWWWWWWWWWWWWWWW
W------------------W
W------------------W
W-----------W------W
W----W------W----WWW
W---W---W---W------W
W-----------W------W
W-----------W--W---W
W-----------W--W--WW
WW-W--WWW---W--W---W
W------------------W
WWW---------W----X-W
W-----------W----W-W
W-----------W------W
W-----------------WW
W---W-------W----W-W
WW-WW--------------W
W---W--------------W
W------------------W
WWWWWWWWWWWWWWWWWWWW
