WWWWWWWWWWWWWWWWWWWW
W-------W----------W
W------------------W
W----W--W------W--WW
W----W--W------W---W
W-------W----------W
W------------------W
WW-----------W-W---W
W--W-W---------W---W
WWW------------WWXWW
WW-WW---W------W---W
W---W--------------W
W----------W-------W
W----------W-------W
W----------W---WWWWW
W----------W------WW
W------------------W
W------------------W
W------------------W
WWWWWWWWWWWWWWWWWWWW
