WWWWWWWWWWWWWWWWWWWW
W------------------W
W------------------W
W----W-------------W
W----W-----------WWW
W----W------X----W-W
W----W--WW-------W-W
W----W-------------W
WW-----------------W
W------------------W
W-W----------------W
W-------WW---------W
W------------------W
W------WWWW-----W-WW
W------W----------WW
W------WW-W-------WW
W------WW--------W-W
W------W-----------W
W------------------W
WWWWWWWWWWWWWWWWWWWW
