WWWWWWWWWWWWWWWWWWWW
W------------------W
W------------------W
W-----------------XW
W-------WWW--------W
W------------------W
W------------------W
W--------W--W-WW---W
W------------------W
W--W---------------W
W--W---------------W
W---------W------W-W
W---------W--------W
W-W----------------W
W----------W---W--WW
W---WWWW-------W---W
W---W------W---W--XW
W----------W-------W
W------------------W
WWWWWWWWWWWWWWWWWWWW
