WWWWWWWWWWWWWWWWWWWW
W------------------W
W------------------W
W----------------WXW
W------W---------W-W
W------W---------W-W
W------WW--------W-W
W------------------W
W---------X------X-W
W-------W----------W
W------------------W
W------------------W
W-------W----------W
W-W----------W-----W
W----W-------W-----W
W-W--W-------WW----W
W------------WW----W
W------------------W
W------------------W
WWWWWWWWWWWWWWWWWWWW
