WWWWWWWWWWWWWWWWWWWW
W------------------W
W------------------W
W-----------------WW
W-----------------WW
W---------W-------WW
W---------W-------WW
W---------W-------WW
W-----W---W-------WW
W---------W--------W
WWW----------------W
W---W-----WWW-----XW
WW--W-----------W-WW
W-------------W----W
W-------------W----W
W-------X-----W----W
W----W--W-----W--W-W
W---X---------W----W
W-----------------XW
WWWWWWWWWWWWWWWWWWWW
