WWWWWWWWWWWWWWWWWWWW
W------------------W
W----------W-------W
W----------W------WW
W----------------XWW
W------------------W
W----------------WWW
WW---------------W-W
WW---------------WWW
W------WWW-------WWW
W-------W-----W--W-W
W------------------W
W------------------W
W-----------------WW
W--------W--------WW
W------------------W
W-WW--------WWW---WW
W------------------W
W-WWW--------------W
WWWWWWWWWWWWWWWWWWWW
