WWWWWWWWWWWWWWWWWWWW
W------------------W
W------------------W
W-----W-W----------W
W-----W-W----------W
W-W--WW------WWWW--W
W------------------W
W------------------W
W------------------W
W-----------W------W
W------------------W
W-----------W------W
WWW---------W---X--W
W--------W------W-WW
W--W---------------W
W------------------W
W------------------W
W------------------W
W------------------W
WWWWWWWWWWWWWWWWWWWW
