WWWWWWWWWWWWWWWWWWWW
W------------------W
W------------------W
W------------------W
W-----------W-W----W
--------------W----W
W--X-------W-------W
W-------------WW---W
W----------W---W--WW
W----W-----W---W-WWW
W----------WWWWW---W
W------------------W
W------------W-----W
W------------W-----W
W-W----W-----------W
W-W------------W---W
W------------------W
W---------W--------W
W------------------W
WWWWWWWWWWWWWWWWWWWW
