WWWWWWWWWWWWWWWWWWWW
W------------------W
W------------------W
W------------------W
W------------W-----W
W-----------------WW
WW--------X-------WW
W-------WWWWWWWW--WW
WWWWW-------------XW
W-----------------WW
WWW-WWWWWW--------WW
W-----------------WW
W------------------W
W----W-WW----------W
W------WWW---------W
W-W---------X------W
W-------WWWWWW-----W
W------------------W
W-W----------------W
WWWWWWWWWWWWWWWWWWWW
