WWWWWWWWWWWWWWWWWWWW
W------------------W
W------------------W
W----------WWW-----W
W----------W-------W
W-W-----W----------W
W-W--------W-------W
W-W--------------WWW
W-W-----------X----W
W-W---------------WW
W-W--WWW----W-WWWWWW
W------------------W
WWWW-WW-----------XW
W-----W------------W
W-------------X----W
W-----------W-W----W
W-----------W-----WW
W------------------W
W------------------W
WWWWWWWWWWWWWWWWWWWW
