WWWWWWWWWWWWWWWWWWWW
W------------------W
W------------------W
W----W---------W---W
W--------------W---W
W--------------W--XW
W--------------W---W
W--------------W---W
WW-----------------W
W------W----W--W---W
WWW----W----W-----WW
W------W---------WWW
W-W---------W------W
WW--W------------W-W
W----------------W-W
WW---------------W-W
WWWWW--------------W
W------------------W
W------------------W
WWWWWWWWWWWWWWWWWWWW
