WWWWWWWWWWWWWWWWWWWW
W------------------W
W------------------W
W------------------W
W----WW---------W--W
W-WW---------------W
W------------------W
W------------------W
WWWW-WW-W--W-------W
W---------------WW-W
W-----------W---W--W
W------------------W
W---------------WXWW
W------------------W
W------------------W
W-----------------WW
W------------------W
W------------------W
W------------------W
WWWWWWWWWWWWWWWWWWWW
