WWWWWWWWWWWWWWWWWWWW
W------------------W
W------------------W
W-----W-------W----W
W-----W-----------XW
W---WWW------------W
W------------------W
W----W-------------W
W----W-W-WWWW------W
W----W----------WX-W
W---------------W--W
W----WWW-----------W
WW---W-------------W
WW----------W-W----W
W-----------W------W
WW-----------------W
WW---------------W-W
W------------------W
W------------------W
WWWWWWWWWWWWWWWWWWWW
