WWWWWWWWWWWWWWWWWWWW
W------------------W
W----------------W-W
W----------------W-W
W----------------W-W
W-W---------WWW--W-W
W-----------WWW----W
W-------W---W------W
WWW---------W-WW---W
W-----------W-WW---W
WWWW-----W----W----W
WWW-----------W---WW
W-------------WW-W-W
W-------------W----W
W----WW------------W
W---------W-------WW
W---------W-------XW
W------------------W
W------------------W
WWWWWWWWWWWWWWWWWWWW
