WWWWWWWWWWWWWWWWWWWW
W------------------W
W------------------W
W------------------W
W-----W------------W
W--WW--------------W
W------------------W
W------------------W
W-----------------WW
W------------------W
W------------------W
W-WW---------------W
W------------------W
W--WW----------X---W
W--W-----------WWWXW
W--W------W-W-----WW
W-WW---------------W
W--W--------------WW
W------------------W
WWWWWWWWWWWWWWWWWWWW
