WWWWWWWWWWWWWWWWWWWW
W------------------W
W------------------W
W-----W---WWWW-WW--W
W------------W--W--W
W---------------W--W
W---------------W--W
W------WW-------W--W
W---------------W--W
W-----------W---WWWW
W--X--WW-----------W
W-------------WWW--W
W-----------WW-----W
W----------WWWWWXWWW
W------------------W
W-----X------------W
WWWW--WW-----------W
W------------W-----W
W------------------W
WWWWWWWWWWWWWWWWWWWW
