WWWWWWWWWWWWWWWWWWWW
W------------------W
W-----------------WW
W------------------W
W----------------WWW
WWWWW---W----------W
W------------------W
W----------------WWW
WWWWW--------------W
W--------W---------W
W--W-------------WXW
W-----W------------W
W--------W---------W
W------------------W
W-----W----------W-W
W-----W-------W---XW
W------------------W
W------------------W
WWW----------------W
WWWWWWWWWWWWWWWWWWWW
