WWWWWWWWWWWWWWWWWWWW
W------------------W
W------------------W
W-----------------WW
W------------------W
W-W-----W--------XWW
WWW-----W-------W--W
W-W-------------W-WW
W-W----------------W
W------------------W
WWW---------------XW
WW--------------WWWW
W------------------W
W----------WW------W
W---X--------------W
W----------------W-W
W------------W-----W
W----X-------------W
W------------------W
WWWWWWWWWWWWWWWWWWWW
