WWWWWWWWWWWWWWWWWWWW
W-----------------WW
W------------------W
W--------W--------WW
W-----------------WW
WW-----------------W
WW--------------WWWW
WW-----------------W
W--------WWWW------W
W------------------W
W-----------WWW----W
W------------------W
W----------------X-W
W--W----------WWWW-W
W----------------W-W
W--W---------------W
W--W----WWWW--W--W-W
W------------------W
W------------------W
WWWWWWWWWWWWWWWWWWWW
