WWWWWWWWWWWWWWWWWWWW
W------------------W
W------------------W
W----------WW--W---W
W-----------------WW
W------W----W------W
W-----------------WW
W-----------W-W-W--W
W-------WWW-W------W
W-W---------------WW
W-W-----W-W-------WW
W-W---------------WW
W-----W-----------WW
W-W---------------WW
W-W---------------WW
WWW-W--------X----WW
W------------------W
W------------------W
W-----------------XW
WWWWWWWWWWWWWWWWWWWW
