WWWWWWWWWWWWWWWWWWWW
W--------------W---W
W------------------W
W----WW------------W
W------------------W
W--W---------------W
W--W------------W-WW
W-------W----------W
W--W---------------W
W------------------W
W-----X---W-------WW
W-W----------------W
W-----------------WW
W------W--W--------W
W-W-------W--------W
WWW----WWWW--W-----W
W------W-----W-----W
W------------W-----W
-------------------W
WWWWWWWWWWWWWWWWWWWW
