WWWWWWWWWWWWWWWWWWWW
W------------------W
W------------------W
W-------WW-WW------W
W-------WWWWW-W----W
W---W---W----------W
W-------W----------W
W-------W----------W
W------------------W
W------------------W
W------------------W
WWW------------W-WWW
W-----------X------W
WWW-------WWW--W-WWW
W------------------W
W-------W----------W
W------------------W
W------------------W
W------------------W
WWWWWWWWWWWWWWWWWWWW
