WWWWWWWWWWWWWWWWWWWW
W------------------W
W------------------W
W----W----------WWXW
W----W-------------W
W------------WWWWWWW
W-------W------WW--W
W------------------W
W-------------W---XW
W-------WW--------WW
W-W------W----W----W
W-W-----------W----W
W-WWW----W---------W
W-WWW--------------W
W--------W---------W
W-----WW-W---------W
W-----W-----------XW
W-----------X------W
W------------------W
WWWWWWWWWWWWWWWWWWWW
