WWWWWWWWWWWWWWWWWWWW
W------------------W
W------------------W
W------W-----------W
W------W-----------W
WW-----W------W----W
WW----------------XW
W---WWWW-----------W
W------------------W
WW-------W--------XW
W--------W---------W
W-----------------WW
W------------------W
W--------W----W----W
W--------W---------W
W------------------W
W------------------W
W------------------W
W------------------W
WWWWWWWWWWWWWWWWWWWW
