WWWWWWWWWWWWWWWWWWWW
W------------------W
W------------------W
W---------X--W-----W
W------------W----XW
WW-----------W----WW
W------------W-----W
W------W--W--------W
W---------W--------W
W---------------W--W
W---------------W-WW
W-W-------------W-WW
W-------WW---------W
W----------------W-W
W---------------W--W
W----WWW-----------W
W----------W-------W
W----------------WWW
W------------------W
WWWWWWWWWWWWWWWWWWWW
