WWWWWWWWWWWWWWWWWWWW
W------------------W
W------------------W
W------------------W
W------------WWWW--W
WW-----------------W
W-WWW--------------W
W-W----------------W
W-W----------------W
W-W------------WWWWW
W-WW--------------XW
W-WW-------------WWW
W---W--------------W
W---W--------------W
W------WW-W--------W
W---WW-WW---------XW
W------------WW-WW-W
W------------------W
W------------------W
WWWWWWWWWWWWWWWWWWWW
