WWWWWWWWWWWWWWWWWWWW
W------------------W
W------------------W
W--------------W--WW
W--------W-----W--WW
W--W--WWWW-----W--WW
W--------------WWWWW
W---W----W---------W
W------------------W
W------------------W
W----WW------W----XW
WW-----------W-----W
W------W-----------W
W-------------W---XW
W-------------W----W
W---------W---W----W
W------------------W
W------------------W
W-----------------XW
WWWWWWWWWWWWWWWWWWWW
