WWWWWWWWWWWWWWWWWWWW
W------------------W
W------------------W
W-------------WW---W
W----W-------------W
WWW----------------W
W-------W----------W
W------------------W
W------------------W
WWW---------------WW
W--------------W---W
W--------------W---W
W-----------------XW
WWW---------------WW
W-WWW--------------W
W-----------------XW
W-------------WW---W
W------------------W
W------------------W
WWWWWWWWWWWWWWWWWWWW
