WWWWWWWWWWWWWWWWWWWW
W------------------W
W------------------W
W-----------W--W--WW
W--------------W--WW
W--------------W---W
W--------------W-WWW
WWW----------------W
W-----------W------W
WW----------W------W
W----------W-------W
W----------W-------W
W----------W-------W
W----------W-------W
W------------------W
WW--W-------------XW
WW--W-----------W--W
W------------------W
W------------------W
WWWWWWWWWWWWWWWWWWWW
