WWWWWWWWWWWWWWWWWWWW
W------------------W
W------------------W
W------------------W
W------------------W
W------------------W
W--W---------------W
W------------------W
W-------W-------W--W
W------------------W
W------------------W
WW--------------W--W
W----W------------WW
W----W----------W-WW
WWWWWW-------------W
WW---WWW-----------W
W----W-------------W
W-----------------XW
W------------------W
WWWWWWWWWWWWWWWWWWWW
