WWWWWWWWWWWWWWWWWWWW
W-------------------
W------------------W
W----W-W-W----W----W
W----W--------W----W
W----W-------------W
W----W---W-WW-----WW
W------------------W
W-----------W------W
W-----------W-WW---W
W-----W------------W
W-----------------WW
W-----WWW-----W---XW
W------------WWW---W
W------------------W
W------W----------WW
W-----------------WW
W-----------------XW
W------------------W
WWWWWWWWWWWWWWWWWWWW
