WWWWWWWWWWWWWWWWWWWW
W------------------W
W------------------W
W-------W----------W
W-------W----------W
W-----W-WW---W----XW
W-W----------------W
W------------------W
W-W--W-------W-----W
W-W--W-------W--W--W
W-W-------W--W-----W
W-W-WWWWWWWW-------W
W-W---------------XW
W---------------W--W
WW-WWWWWW---------WW
W------------------W
W------------------W
W----W-------------W
W------------------W
WWWWWWWWWWWWWWWWWWWW
