WWWWWWWWWWWWWWWWWWWW
W------------------W
W------------------W
W-------------W----W
W---------WWWWW----W
W------------------W
WW-----------------W
W-----W---------W--W
W-----W------------W
W-----W-----------WW
W------------X-----W
WWW----W-----------W
W-W----W-----------W
W------W-----------W
W------W-----------W
W------W-----------W
W-WW---W-----------W
W-W----------------W
W------------------W
WWWWWWWWWWWWWWWWWWWW
