WWWWWWWWWWWWWWWWWWWW
W------------------W
W------------------W
W-----------W------W
W-----------W------W
W-----------W------W
W-WW--W------------W
W------------------W
W----------WWW-----W
W------------------W
W------W----WWWWW--W
W-----------WW-----W
W-----------W------W
W-----------W--W-WWW
W-----------WW-----W
W--WW--------------W
W------------X--W--W
W----W-------------W
W------------------W
WWWWWWWWWWWWWWWWWWWW
