WWWWWWWWWWWWWWWWWWWW
W------------------W
W------------------W
W------------------W
W----------------WWW
W-------------WWWWWW
W-----------W------W
W----WWW----------XW
W-------------W----W
W-------------W----W
W-------------W----W
W----W-------------W
W----W--WWW-W-W----W
W-----------W------W
W-----------W------W
W-W-W-------W----WWW
WWW---------W---W--W
W-----------------WW
W------------------W
WWWWWWWWWWWWWWWWWWWW
