WWWWWWWWWWWWWWWWWWWW
W------------------W
W------------------W
W-----W------------W
W-----------W------W
W---------------W-WW
W--WW--------------W
W-XWW-W-----------WW
W--W--WW----------WW
W--W-W-W--WWWWWWW--W
W------------------W
W------------------W
W--W------------W--W
W---------------W--W
WW--------------W--W
W--W-W------W------W
W------------------W
W-----------------WW
W----W-------------W
WWWWWWWWWWWWWWWWWWWW
