WWWWWWWWWWWWWWWWWWWW
W------------------W
W------------------W
W----------W-------W
W----------W-------W
WWW--------W-W-W--WW
W----------W-------W
WWWW---------------W
W-W---W------------W
W-----W-W----------W
W-----W------------W
W--W--W-----------WW
W-----X--W-W-------W
W-----WW----------WW
W-W----------------W
W------------------W
W---W--------------W
W------------------W
W------------------W
WWWWWWWWWWWWWWWWWWWW
