WWWWWWWWWWWWWWWWWWWW
W------------------W
W------------------W
W------------------W
W------------------W
W-W----------------W
WWW----X-----------W
W-W---WW--------W--W
W-W----------------W
W-W-----W----------W
W-W----WWWWW-------W
W-W----------------W
W----------W-------W
WW---------W-------W
WW-----------------W
W------------------W
W------------------W
W------------------W
W------------------W
WWWWWWWWWWWWWWWWWWWW
