WWWWWWWWWWWWWWWWWWWW
W------------------W
W---------W--------W
W---------WW-------W
W---------W-------XW
W---------W--------W
WW--------WW-------W
WWW-W------W-------W
W---W------W-------W
W---W------W-W-----W
W---W-W----W-------W
W----------W-------W
W----------W-------W
W------W-W-WW------W
W-W------W---------W
W--------W---------W
W--------W---------W
W------------------W
W------------------W
WWWWWWWWWWWWWWWWWWWW
