WWWWWWWWWWWWWWWWWWWW
W------------------W
W------------------W
W------------------W
W-----------W------W
W------------------W
W--W--WWWWW--------W
W--W---------------W
W----------------W-W
W----------------W-W
W-----WW--W--------W
W-------------W----W
W-W----------------W
W-------WW---------W
W------------------W
W------------------W
W-----W-W-W--------W
W------------------W
W------------------X
WWWWWWWWWWWWWWWWWWWW
