WWWWWWWWWWWWWWWWWWWW
W------------------W
W------------------W
W------------------W
W------------------W
W-------WW---------W
W-------W----------W
W-------W---------WW
W-------W----------W
W-------W---W------W
W-WWWW--W----------W
WWW-----W----------W
W-W-----W-W------XXW
W-W-----W-W-----WW-W
W-W-------W--W-----W
W---------WWWW-----W
W-W-WWW---W-----W--W
W------------------W
W------------------W
WWWWWWWWWWWWWWWWWWWW
