WWWWWWWWWWWWWWWWWWWW
W------------------W
W------------------W
W------------W--W--W
W------------------W
W------------------W
W-----WWWW------W--W
WWW-------------WWWW
W------------W---WWW
W----------------W-W
W------------W---W-W
W-W---------------XW
W------------W---WWW
W-----W-----W----WWW
W-----------W------W
W-----------W----X-W
W-----------WWWW---W
W--------------W---W
W------------------W
WWWWWWWWWWWWWWWWWWWW
