WWWWWWWWWWWWWWWWWWWW
W------------------W
W------------------W
W-----------------WW
W------------------W
W------------------W
W---------W--------W
W---W------------X-W
W------------WWWWW-W
W------------------W
W----------------W-W
W--------W-------W-W
W------------------W
W---W---W---W---W-XW
W--WW--------------W
W-----------W------W
W-----------W------W
W------------------W
W----------------X-W
WWWWWWWWWWWWWWWWWWWW
