WWWWWWWWWWWWWWWWWWWW
W------------------W
W------------------W
W----------W-----XWW
W----------W-------W
W----------W-------W
W------W---W-------W
WW---------W--W---WW
W------W----------WW
W------WWWWW--W---WW
W-------------W----W
WW-----------------W
WW------------W---WW
W------------------W
W-----WW----------WW
WWWWWWW-----------WW
W---------W-------WW
W-----------------XW
W------------------W
WWWWWWWWWWWWWWWWWWWW
