WWWWWWWWWWWWWWWWWWWW
W------------------W
W------------------W
W------------W-----W
W------------W----WW
W-----------WW----WW
W-----------------WW
W-----------WWW----W
W-----------W-----WW
W---------W--------W
W-----W---W--------W
W---------W-------XW
W-W---------------WW
W-W---W------------W
W-WWW-------------XW
W-W---------------WW
W-W-----WW---------W
W-W----------------W
W------------------W
WWWWWWWWWWWWWWWWWWWW
