WWWWWWWWWWWWWWWWWWWW
W------------------W
W------------------W
W------------------W
W-----------------WW
W------------------W
W-----WWWWWWWW-----W
W----------W-------W
W-----W----W------XW
W-W---W----W-------W
W-W---W------------W
W-----W------------W
W-W---W----X-------W
W-W----------------W
W--------W---------W
W--------W---------W
W--------------W---W
W---------W--------W
W------------------W
WWWWWWWWWWWWWWWWWWWW
