WWWWWWWWWWWWWWWWWWWW
W------------------W
W------------------W
W----W-------------W
W--------W------WWWW
W---W-------------WW
W---W------WW---W--W
W----------W-WW---WW
W------------------W
W-----------------XW
W---------WWWW-W---W
W------------------W
W---------W--------W
W---------W--------W
W------------------W
W------------------W
W------------------W
W------------------W
W------------------W
WWWWWWWWWWWWWWWWWWWW
