WWWWWWWWWWWWWWWWWWWW
W-------------W----W
W-------------W----W
W-----W-------W----W
W-----W-------W----W
W-----W------------W
W-WWW-W-----------XW
WWWWW-------WWWW---W
W-----------W------W
W-----------------WW
W--W--W------------W
W--------W---WWW--WW
W--------W---------W
WWWWWWW--W---------W
W--------W-----WWW-W
W--------W---------W
W-WWWWW--W---------W
W------------------W
-------------------W
WWWWWWWWWWWWWWWWWWWW
