WWWWWWWWWWWWWWWWWWWW
W------------------W
W------------------W
W----WW------W-W--WW
W---------WW---W-W-W
W-----W------W---WWW
W----------------W-W
W----------------W-W
W-------------W--W-W
W------------------W
W------------------W
W------------------W
W------------------W
WWW----------------W
W------------------W
W--W-W-------W-W---W
W---------X-------XW
W------------------W
W------------------W
WWWWWWWWWWWWWWWWWWWW
