WWWWWWWWWWWWWWWWWWWW
W------------------W
W------------------W
W---------X-------WW
W------W--WW-----W-W
W-W-W--W-----------W
W-W----------------W
W---------W--------W
W-W-W-WWWWWWW-----XW
W---------W-------WW
W-----------------WW
W------------------W
W------------------W
WWWWWW------------WW
W----W---------W--WW
WWWWWWWW-------W---W
W-----------------XW
W------------------W
W------------------W
WWWWWWWWWWWWWWWWWWWW
