WWWWWWWWWWWWWWWWWWWW
W-------W-----------
W-------W----------W
W-------W----------W
W------------------W
W-----------------WW
W-----W-WWWWWWW----W
W-----W-----WW-----W
W---WWW------------W
W----W------------WW
W-----------------WW
W----W---------W--WW
W----W------------XW
WWW-WW----W--------W
W---------W----W---W
W------WW-W--------W
W------------------W
W------------------W
W------------------W
WWWWWWWWWWWWWWWWWWWW
