WWWWWWWWWWWWWWWWWWWW
W------------------W
W------------------W
W----------W-------W
W------------------W
W------------------W
W------------------W
W-----------------XW
W------W-----------W
W---W--------------W
WW-----------------W
WWW--------------WWW
W-WWWWWWWWW--------W
W-----------------WW
W-W----------------W
W-W----------------W
W-WW-----------W-W-W
W------------------W
W------------------W
WWWWWWWWWWWWWWWWWWWW
