WWWWWWWWWWWWWWWWWWWW
W------------------W
W------------------W
W-------W------W-W-W
W-------W----------W
W-------W--W-------W
W---W---WW---------W
W-------W----------W
W---W---W--X------WW
W-----------------XW
W------------------W
W---W--------------W
W--W-------W-------W
W----------W-------W
W--W-------W-------W
W----------W-----W-W
W--W---------------W
W------------------W
W------------------W
WWWWWWWWWWWWWWWWWWWW
