WWWWWWWWWWWWWWWWWWWW
W------------------W
W------------------W
W-----------W------W
W-----------WWW----W
W-----WW-----------W
W------------------W
W-----------W------W
W-----------------WW
WW-----------------W
W------W----W------W
W------W----------WW
W------W----------WW
W------W-----------W
W------------------W
W-------W-WWW--WW-XW
W-------W------WW--W
WW-----------------W
W------------------W
WWWWWWWWWWWWWWWWWWWW
