WWWWWWWWWWWWWWWWWWWW
W------------------W
W------------------W
W------WWW---------W
W------W-----------W
WWW----------------W
W----------W------XW
W---W------W------WW
W----------W------WW
W---W------W------WW
W---W------W------WW
W----W-WWW-W------WW
W----W------------WW
W----W-------------W
W----W--------W--WWW
W----------------WWW
W------------------W
W------------------W
W------------------W
WWWWWWWWWWWWWWWWWWWW
