WWWWWWWWWWWWWWWWWWWW
W-------------------
W------------------W
W----W---------W---W
W----W---------W---W
W----W-----W------XW
W----------W------WW
W----------W-------W
W---W--W-----------W
W---W------W-----W-W
W--------WWW-------W
W-W-WW-W-----------W
WWW----------W-----W
W---WW------WW-----W
W-W-WW-------W-----W
W----W-------W-----W
W----------------WWW
W------------------W
W------------------W
WWWWWWWWWWWWWWWWWWWW
