WWWWWWWWWWWWWWWWWWWW
W--------------W----
W--------------W---W
W--------------W---W
W--------W-WW--W-WXW
W------------------W
WW------WWWW-------W
W-------W---------WW
W-----------------WW
W-------W--------WWW
W-----------------XW
W--------WW-W---XWWW
W--------WW-W------W
W------------W-----W
W--------W---------W
WWW------W------W--W
W--------WWWWWWW---W
W------------------W
------------------WW
WWWWWWWWWWWWWWWWWWWW
