WWWWWWWWWWWWWWWWWWWW
W------------------W
W------------------W
W-----------------XW
W-----W-----------WW
W------------------W
WW----------------XW
W-------WW--------WW
W--------W---------W
WW----------------XW
WW-------W--------WW
WW-------W-----W--WW
W------------------W
W------------------W
W------------------W
W------------------W
W--------------W---W
W------------------W
W------------------W
WWWWWWWWWWWWWWWWWWWW
