WWWWWWWWWWWWWWWWWWWW
W------------------W
W------------------W
W------------------W
W------------------W
W-------W--W-------W
W------------------W
W-------W-WWW-----XW
W-------W---------WW
W-------W----------W
W-------W-WWW------W
WW-----------------W
W------------------W
W-W-W-------WW-----W
W---------W--------W
W---------W--------W
W-------------WW--WW
W------------------W
W------------------W
WWWWWWWWWWWWWWWWWWWW
