WWWWWWWWWWWWWWWWWWWW
W------------------W
W------------------W
W------W-----------W
W-----------WW--W-XW
W------------W--W-WW
W-W-------------W--W
W-W--------WWWW-W--W
WWWW------------W--W
W---WWWWW-----W----W
W-----W-WW--------WW
W------------------W
W------------------W
W------------------W
W-----------------WW
W--------W------W--W
W----WW---------W-WW
W------------------W
W------------------W
WWWWWWWWWWWWWWWWWWWW
