WWWWWWWWWWWWWWWWWWWW
W------------------W
W------------------W
W------------WW----W
W------------W-----W
W------------------W
W---W--------------W
W---W---------W----W
W---W------W-------W
W---W--------------W
W---WW-------------W
W----W-------------W
W----W------W------W
W----W------W---WWWW
W----W------W------W
W-----------W----WXW
WWW---------W-----WW
W----------------X-W
W-------------------
WWWWWWWWWWWWWWWWWWWW
