WWWWWWWWWWWWWWWWWWWW
W------------------W
W----------W-------W
W----------W-------W
W----------W----W--W
W----------W-------W
W-----------------XW
W------------------W
W---W--------------W
W------W--WWW------W
W---W-------------WW
W------------------W
W-----------------WW
W----------------XXW
W-----------------WW
W------------------W
W------------------W
W------------------W
W------------------W
WWWWWWWWWWWWWWWWWWWW
