WWWWWWWWWWWWWWWWWWWW
W----------------W-W
W----------------W-W
W----------------W-W
W------------------W
W-----------W---W--W
WWWWWW------WWW-W--W
W--------WW--------W
W--------WW-W---W-XW
W---------------WW-W
W--------WWWW----W-W
W------------------X
W--------------WWWWW
W------------------W
W--------W--------WW
W---------------W--W
W------------------W
W------------------W
W------------------W
WWWWWWWWWWWWWWWWWWWW
