WWWWWWWWWWWWWWWWWWWW
W------------------W
W------------------W
--------W---WWW--W-W
W-------W-----WWWW-W
-------------------W
W-------W----------W
W----------------W-W
W------------------W
W------------------W
W------------------W
W--------WWWWWWWW--W
W------------------W
W------------------W
W---------------WWWW
W-W----------------W
W------------------W
W-----------------XW
W------------------W
WWWWWWWWWWWWWWWWWWWW
