WWWWWWWWWWWWWWWWWWWW
W------------------W
W------------------W
W----------------WWW
W--------W---------W
W-----------W------W
W------------------W
W--W-W------W------W
W------------------W
W------------------W
W-------------WWWWXW
W------------------W
W------------------W
W-------W-----W--WWW
W------------------W
W-----W------------W
W----------WW------W
W------------------W
W------------------W
WWWWWWWWWWWWWWWWWWWW
