WWWWWWWWWWWWWWWWWWWW
W------------------W
W------------------W
W------W--W-WWWW---W
W------------------W
W------W-----------W
W-W----W----W------W
W-W----W----------WW
W-----------------WW
W--W--------------WW
W------X-----------W
WWWWWWWW-----------W
W------------------W
W------------------W
W----------------X-W
WW--------------W--W
W--------WW--------W
WWW----------------W
W------------------W
WWWWWWWWWWWWWWWWWWWW
