WWWWWWWWWWWWWWWWWWWW
W------------------W
W------------------W
W------------------W
W--------------W---W
W--------------W--XW
W--------------W--WW
W------------------W
W---------WWWW-W---W
WWWW------W-------XW
W-------W-WWW--W---W
W--------------W---W
W----W--W------W---W
W------------------W
W----W---------W---W
W----W--WWWW-------W
WW-----------------W
W------------------W
W------------------W
WWWWWWWWWWWWWWWWWWWW
