WWWWWWWWWWWWWWWWWWWW
W------------------W
W------------------W
W-----W------------W
W------------------W
W-----W--W-X-------W
W-----W-WWWW-------W
W------------------W
W-----W------------W
W--------WW--------W
W------------------W
W-W----------------W
W-W----------W-----W
W-W----------------W
W------------------W
W-W--------------W-W
W----------------W-W
W----------------W-W
W----------------W-W
WWWWWWWWWWWWWWWWWWWW
