WWWWWWWWWWWWWWWWWWWW
W------------------W
W------------------W
W----WWWWW-W------WW
W-----WWWW---------W
W-----------------WW
W-------------WW---W
W------W-----------W
W------W------W----W
W-------------W----W
W---W--W------W----W
W-----WW------W----W
WWW--------WWWW----W
W-----W------------W
W-----WW-----------W
W-W---W----W-------W
W-----W---------W-WW
W-----W-----------XW
W------------------W
WWWWWWWWWWWWWWWWWWWW
