WWWWWWWWWWWWWWWWWWWW
W------------------W
W------------------W
W----W-------------W
W------------------W
WWWW---------------W
W--------------W---W
W------------------W
W-----W------------W
W-----W---------W--W
W-----W--W--WW--W--W
W--------W---------W
W--------WWWWW--WWXW
W-----------W--WW--W
W------------------W
WWW---------------WW
W-------W----------W
W------------------W
W------------------W
WWWWWWWWWWWWWWWWWWWW
