WWWWWWWWWWWWWWWWWWWW
W------------------W
W------------------W
W-----W------------W
W-----W-W----------W
WWW---W-----WWW----W
W-----W-WW---------W
W-----W--W----W--W-W
W----------------W-W
W-W--------------WWW
W------------------W
W-W---------------WW
W-W---------------WW
WWW---XWWWWWW-----WW
WWW-------W-W-----WW
WW-----------------W
W-----------W------W
W------------------W
W-----------------WW
WWWWWWWWWWWWWWWWWWWW
