WWWWWWWWWWWWWWWWWWWW
W----W-------------W
W----W-------------W
W----W--W----------W
W----W------------WW
W-----------------WW
W------------WW---WW
W------------------W
W------------W-----W
W------------------W
WWW-W--------------W
W-W-W--------------W
W---W-------------WW
W---W-----------X-WW
W---W-W----W-WWWW--W
W---W--------------W
W-----------------WW
W------------------W
-------------------W
WWWWWWWWWWWWWWWWWWWW
