WWWWWWWWWWWWWWWWWWWW
W-----------W------W
W------------------W
W------------------W
W----------W-------W
W-W--------W-------W
W------------------W
W-W-----------XWWWWW
WWWW--------W------W
W------------------W
W---------W--W---WWW
W---------W--W----WW
W-----------------WW
W------------------W
W---------------W-WW
W------------------W
W------------------W
W---------------W-WW
W------------------W
WWWWWWWWWWWWWWWWWWWW
