WWWWWWWWWWWWWWWWWWWW
W------------------W
W------------------W
W------------------W
W-----------------WW
W-------------WW---W
W-W------W---------W
W-W----------------W
W-W--------W-------W
WWW--XWWWW-W-------W
W-W-------WW-------W
WW---------W------WW
WW---------W-------W
W------------------W
W-----------------WW
W-------WWWW-------W
W------------------W
W------------------W
W------------------W
WWWWWWWWWWWWWWWWWWWW
