WWWWWWWWWWWWWWWWWWWW
W-------------------
W------------------W
W------------------W
W------------------W
W-W----------------W
W-------WW---------W
WWWWWWWW-----W-----W
W------------------W
W-W----WWWWW-----WWW
W-------W----------W
W-------W----------W
W------------------W
W---------------XWWW
W------------------W
W--------W----W----W
W--------W---------W
W--------W-------X-W
W------------------W
WWWWWWWWWWWWWWWWWWWW
