WWWWWWWWWWWWWWWWWWWW
W------------------W
W------------------W
W-------W----------W
W-------W----------W
W-----------WW-----W
W------------------W
W----------------XWW
W------------------W
W------------------W
W------------------W
W--W-------------W-W
W------------------W
W------------------W
W------------------W
W--------W---WW----W
W-----W------------W
W------------------W
-------------------W
WWWWWWWWWWWWWWWWWWWW
