WWWWWWWWWWWWWWWWWWWW
W------------------W
W------------------W
W----WWW-----------W
W---------------WWWW
W--W----WW---------W
W-----------X------W
W------------------W
W--W----WWW--------W
W--W----W---------WW
W--W---------------W
W-------W----------W
WW--W--------------W
WW--------W----W---W
W-------WWW--------W
W-WW----W-W--------W
W-----------------WW
W------------------W
W------------------W
WWWWWWWWWWWWWWWWWWWW
