WWWWWWWWWWWWWWWWWWWW
W----------------W-W
W------------------W
W---------W--------W
W---------W--------W
W---------W--------W
W---W--------------W
W---W--------------W
W---W--WWWW-------XW
W---W-------------WW
W------------------W
W------W-----------W
W------------------W
W------------------W
W-----W------------W
W------------------W
W-------------WWWWWW
W------------------W
W------------------W
WWWWWWWWWWWWWWWWWWWW
