WWWWWWWWWWWWWWWWWWWW
W------------------W
W------------------W
W------W-----WWW---W
W---------WW-------W
W------------------W
W------------------W
W------W-----------W
W-W----W----X--WWWWW
W------W----W------W
W-----------W------W
WWWW---W-W--W------W
W--W---------------W
W--W-W-------------W
W------------------W
W--W-------------WWW
W------------------W
W------------------W
W------------------W
WWWWWWWWWWWWWWWWWWWW
