WWWWWWWWWWWWWWWWWWWW
W------------------W
W------------------W
W-------------X----W
W-----------------WW
W-W----------------W
W-W--------W------XW
W-W----------------W
W-W----------------W
W---------W-------WW
W---------W--------W
WWWW------WWWWW----W
W---------W--------W
W-W-------W-------XW
W----W----W----WW-WW
W---------------W-WW
W------------------W
W------------------W
W------------------W
WWWWWWWWWWWWWWWWWWWW
