WWWWWWWWWWWWWWWWWWWW
W-----------------WW
W------------------W
W-----W-------W----W
W-----W------------W
W-----------W-W----W
W-----W----------X-W
W--------WWW-WWWWW-W
W---------W--------W
WW-----------------W
W------------------W
W---------W-W------W
W-----------------WW
W------------------W
W------------------W
WW--------------WWWW
WW-----------------W
W------------------W
W------------------W
WWWWWWWWWWWWWWWWWWWW
