WWWWWWWWWWWWWWWWWWWW
W------------------W
W------------------W
W-----WW----W-W----W
W-----W----WW--WWWWW
WWWWW--------------W
W-------X----------W
WW--X---W--------X-W
W---W---W----------W
W-----WWWWW--X---X-W
WWWW---------WWWW--W
W------------W----XW
W---------X--WW-WWWW
W------------------W
W----WW-----W------W
W----WWWW---W---WW-W
W-----------W---WW-W
WWWWW-W--X--W------W
W-----------W-------
WWWWWWWWWWWWWWWWWWWW
