WWWWWWWWWWWWWWWWWWWW
W------W---W---W---W
W-----WW-----------W
W------W-----------W
W------W-----------W
W------W--WW----W--W
WWW--------WW-XX---W
W--------------W--XW
W--------------W---W
WWW-W----WWW-------W
W-W-------X----W--WW
-------W--W--------W
W------W--WWWWWWW--W
WWW----WWWW-----W-WW
WWWW---------------W
------------------XW
W-----------WWWWWWXW
WWWWWWW------------W
W-------X----------W
WWWWWWWWWWWWWWWWWWWW
