WWWWWWWWWWWWWWWWWWWW
W------------------W
W------------------W
W--------------WWW-W
W------------------W
W-W------W---------W
W-------------WW---W
WWW----------------W
-------------------W
W----WW-----------WW
W----W---------X---W
W--------------WX--W
W-----------X------W
W------------------W
W---------X--------W
WW-----------------W
W-----------X-W----W
W----------------XWW
W----------------X-W
WWWWWWWWWWWWWWWWWWWW
