WWWWWWWWWWWWWWWWWWWW
W--------------W---W
W------------------W
W------------------W
W-----WWWW--W---X--W
W------------------W
WWWWW-------W---W--W
W---------------W--W
W------X---W------WW
W-------------WWWWWW
WW-----------------W
WW----------------WW
W-------W-----WW---W
W------XW--XW-----WW
W------------------W
---------W---W-----W
WWWW-----W---W-W-W-W
W-----------WW---X-W
W------------------W
WWWWWWWWWWWWWWWWWWWW
