WWWWWWWWWWW-WWWWWWWW
W---------W--------W
W------------------W
W-------------W-WW-W
W----WWW-WWW-------W
W---------W--------W
WX---------W---WWWWW
W---W-----WW-------W
W---------WW---X---W
WWWW---W-WWW----X--W
W----WWWWWWW-------W
W----------W----W--W
W----W--W--W-------W
W-W--W-----WW--W---W
WWWXW----------W---W
W-------W------W---W
W--------------W---W
W---W--------------W
W-----W------------W
WWWWWWWWWWWWWWWWWWWW
