WWWWWWWWWWWWWWWWWWWW
W------------------W
W------------------W
W----WW-X----------W
W-------------WWWW-W
WW-----------------W
W---W------WW-WWW--W
W---------------WWWW
W---W-W-----W------W
W--XW----WW-------WW
W------------------W
WWW-----------------
W-------------W--WXW
WWW-----W-----W--WWW
W-W--WWWW----WWWWW-W
W-W--W----W---W----W
W-------WWW--WW----W
W------------WW--W-W
W---------X--------W
WWWWWWWWWWWWWWWW-WWW
