WWWWWWWWWWWWWWWWWWWW
W------------W-----W
W------------------W
W----WW--W---------W
W-----------------WW
W-W--WWWWW---------W
W-W------------W---W
--W--W---W-----W---W
WWW----------------W
WW-----W----W--W---W
W----------XW--X--XW
W-X-----------WW---W
W------------------W
W-----------X--W---W
W---W--WWW-WW--W---W
WWWW---X-----------W
WWWWWWWWWW--W--W--XW
W------------------W
W------------------W
WWWWWWWWWWWWWWWWWWWW
