WWWWWWWWWWWWWWWWWWWW
W--------------W--WW
W------------------W
W------------------W
W----------------XWW
WW---------X-------W
WW---------W--W----W
WW------------------
W--W---------------W
W--W-W---W-----X---W
W-W---X--W----X----W
W-----------WWW--X-W
W--------W---------W
W-----------XX-----W
W--------X--WX-----W
W-------WW------W--W
W---W--------------W
W----W------------XW
WW----------X------W
WWWWWWWWWWWWWWWWWWWW
