WWWWWWWWWWWWWWWWWWWW
W------------------W
W------------------W
W-----------WW-----W
W-----W--X--WWWWWWWW
W--------WW-WW---WWW
WW--X--------W--WW-W
W---W--------W-----W
WWWW------WWWWWWWW-W
W---------W--------W
WW-WWWWW-----------W
W--------WWW------WW
WWWWWWW--------W---W
WW----W--------W--XW
W---------W-W-W----W
W-WW--WWWWW-W----WWW
W-XW--------W------W
WW---------------WWW
W--------------W---W
WWWWWWWWWWWWWWWWWWWW
