WWWWWWWWWWWWWWWWWWWW
W------W-----------W
W------------------W
W-----WW----W--WWWWW
W----XW-----WW-WW--W
W--------W-WWW-WW--W
WW-W--W--W---------W
WW-------WWWWW--X--W
W---------------W--W
WW--------------WWWW
WW--W-----WX-------W
WW--------W----WW--W
WW-WWWW-WX-----W---W
WW------WWW----W--XW
WW-----------------W
WW---X-------------W
W-------WWW-W--W---W
WWW-----W--X--WWW-WW
WW-----------------W
WWWWWWWWWWWWWWWWWWWW
