WWWWWWWWWWWWWWWWWWWW
W----------W-------W
W----------W-------W
W-----------------WW
W-------------W----W
W--WW--WWWW--X-----W
WWWWW--------------W
WW-W--X------WWWWWWW
W------------------W
W--------WW-------WW
WXW-------W-------WW
W-X---------------WW
W-W-------W-------XW
W-W----------------W
W------------------W
WW--WWWW-XW-WWWW---W
WW--W-WW-X---W-----W
WW--W--------------W
WW--WW-------------W
WWWWWWW-WWWWWWWWWWWW
