WWWWWWWWWWWWWWWWWWWW
W-----------------WW
W------------------W
W-------W-W--------W
W----W----W--W-----W
WW-------------X---W
WWWW-----------W---W
WWWWWWWWW----------W
W--W----------------
W--WW---WW-------X-W
W--W--------W----W-W
W--W--------WWW----W
WW-----W----------XW
WWX----W---WWWWWW--W
W------WW-W--------W
WWW-W--XW----------W
W-WWW-WWW----W---W-W
W-----WWWWWWWW-----W
W--X--W------------W
WWWWWWWWWWWWWWWWWWWW
