WWWWWWWWWWWWWWWWWWWW
-------------------W
W--------WW--------W
---------------W---W
W-------W-W-W------W
W--X---WW-W---WW---W
W--WW--WW-W---W----W
W---W-----W-W-W----W
W---W------------WWW
W---WW------------WW
W------------------W
W---------X--------W
W---------W--------W
W-X--X----W--W--W--W
WWW-------X--------W
W---------W----W---W
W-----W------------W
W----W-----WW------W
W----------W-------W
WWWWWWWWWWWWWWWWWWWW
