WWWWWWWWWWWWWWWWWWWW
W------------W---W-W
W------W-----W-----W
W------W-WW--W-----W
W------------W-----W
W----WW--X---------W
WW---X---WW------X-W
WWWWW---------W--WWW
WW----------WW-----W
W----------WWWWWX--W
W-----WX----WW-----W
WWWW--------WW-W---W
W-X-----WWWWWW-WWW-W
W-W--WWWWW-----WW--W
W----W--W----------W
W----WWWWWWWWW-W---W
W-----------------WW
W--WW--WWWW--------W
W--------WWWWWW----W
WWWWWWWWWWWWWWWWWWWW
