WWWWWWWWWWWWWWWWWWWW
W------------------W
W------------------W
W------------------W
W------X-WWWW------W
W-W--W-------------W
W-W--W-W-WXW-------W
W-X----------------W
W----------W---W---W
WWW--W-----W---WWWWW
WW--WW----WWWWWWWWWW
WW--WW-------------W
WWWW---WW---X------W
W------WWWWWW------W
W----------W-------W
W--------------W---W
W--W-------------WXW
W--W---X---W-------W
W------------------W
WWWWWWWWWWWWWWWWWWWW
