WWWWWWWWWWWWWWWWWWWWWWWWWWWWWW
W----------------X-----------W
W--------X----W-------W------W
W--W--------X-----------WW---W
W----W--------W-W-----W------W
WW-W------X-----------XW-----W
W------W----------------W----W
W----W--W-W---W-W------------W
W---WW-X--------X-----------WW
W------W--W-------W----------W
W------W--W-X---W--WW--W--W--W
WW----WW-----X------W----X--XW
W-W-X-WX---------------------W
WW-------------W---X---------W
W--WW----W--W---W--W-W------WW
W------------X----------W----W
W--------W-------------WX----W
WW----WW---------------W-W-X-W
W-----W------W-WW--W---W-----W
W-W-W---------X-----------W-WW
W-----W-----------------WW---W
W------W-------WW--W-W-----W-W
W-----------------W----------W
W-----W---------X-----W---W--W
W------WW---W--W------W------W
W-----W--------W----W-------XW
W---W-X-----------------W-W--W
W-----------WW---X----X------W
WW---------------------------W
WWWWWWWWWWWWWWWWWWWWWWWWWWWWWW
