WWWWWWWWWWWWWWWWWWWWWWWWWWWWWW
W------------W------------X--W
W---X--W------W--------------W
W-W------W--W-----------WW---W
W---W------X------W--W-------W
W---W------W-----W---X-------W
W-------------W--W----W------W
W--W--X------------W---------W
W-------------W-W---W--W-----W
W-W------X--------W---------WW
W-------W----------------W---W
W----W---X-XW----W---W-W-W---W
WWW--------X--WWW-W-W--------W
W--WWW------------X-W--------W
W--X---W------W----------W--WW
W--WW--WW---X-----XW---------W
W------W---------W-----W-----W
W-----------WW-W------W------W
W---------W--W--------W---X--W
WX-------X---------------W---W
W---XW----------------X------W
W----X---WW--W---------WWW---W
W--W---WX-----W---W---------WW
W--X-W-W-------W--------W--X-W
W--WW---X----W---------W-W---W
WW----W----W---------W---W---W
W---W-W----W-------------W-W-W
W---------W---WW-------------W
WX----X-------WW-------------W
WWWWWWWWWWWWWWWWWWWWWWWWWWWWWW
