WWWWWWWWWWWWWWWWWWWWWWWWWWWWWW
W-----------------W-W---X--W-W
W--W------W-----W------------W
W----W------------W----------W
W-----------------X-X--------W
WW--W-----------X--------WW--W
W-------W--W------------W-W--W
W-------W-----------WWW--W---W
W----W----W-----W------X-----W
W------W---------------------W
W-WW-XW-W-------W-W----------W
W---W---------------W-------WW
W-W----W--W-----------------WW
WWW--W-----------------W---W-W
W-------------------WWW--WW--W
W--------WWW-W--------W------W
W---------W------W----X--W--WW
W----W----WW-------X---------W
W---W---WW-----W------W--WW--W
W-----W-W------X-------W-----W
W----WWX------------------W--W
W------W--W---------WX----W--W
W-----W------W-W--X---------WW
W-W-------X------W--W--------W
W-----------XX-----X--------WW
W------W--------WW---W-------W
WXW-----W-----W---------WW---W
W-------------W--W-X---------W
W--------------WW-W--------XWW
WWWWWWWWWWWWWWWWWWWWWWWWWWWWWW
