WWWWWWWWWWWWWWWWWWWWWWWWWWWWWW
W----W------------------W----W
W-------------------------X--W
W--------X---------X--------WW
W-------W-------W------------W
W------------W---------W-----W
W-X----XW-W--------------W---W
W-----------------W----------W
W----X---------------------W-W
W--------------------------X-W
W------------------W-------W-W
W--X-------------------------W
W-----W----------------------W
W-------W-----------X------XWW
W---X----------------------W-W
WW---X----------------------XW
W--------------W--X----------W
W-----------------W----------W
W--------------X-------------W
W---------W------------------W
WW--------------------X------W
W--X------------W------------W
W------------------W--X---W--W
W--W----X-----------W--W-----W
W---X--------WW---W----------W
W-W--W--------W-------------WW
W------XXW---------W-----X--WW
W-----W---------------W------W
W----------W-----------------W
WWWWWWWWWWWWWWWWWWWWWWWWWWWWWW
