WWWWWWWWWWWWWWWWWWWW
W---------WX------XW
W---------W--------W
W---------W--X-----W
W---------W--------W
W------------------W
W-----------------XW
W------------------W
W---------W--------W
WWWWWWWWWWW--------W
W------------X-----W
W-X----------------W
W------------------W
W------------------W
W---------X--------W
W-X----------------W
W------------------W
W---------------X--W
W--X---------------W
WWWWWWWWWWWWWWWWWWWW