WWWWWWWWWWWWWWWWWWWW
W-----XX---------XWW
W--------W------W--W
W----------W-------W
W----W--W-W--------W
W----------W-------W
WX-WWW------W------W
W-----------W------W
W---WW--W-X--WW----W
WX------------X----W
W----W-----W-W-----W
W-------X---------WW
W-W---W---X--------W
W--------XW---W----W
WW----------W--WX--W
W--X---X--W---WX---W
W----W-------------W
W-----------WW--W--W
W-------W-----W----W
WWWWWWWWWWWWWWWWWWWW
