WWWWWWWWWWWWWWWWWWWW
W-----W-------WW-W-W
W---------W--------W
W-----W--W--W-W----W
W--W--------W-W--W-W
W---W----------W-W-W
WW---X------------WW
W---------W------WXW
W-----W---W--------W
W-WWW-------WW----WW
W----X-W--WW---W--WW
W---W---W-W--------W
W-W-W-W-W---W------W
W--------WW--------W
W---W------WW-----WW
W------------W-W---W
W-WW---W-----------W
WWW---W--W---W-----W
W--W-----WW-----W--W
WWWWWWWWWWWWWWWWWWWW
