WWWWWWWWWWWWWWWWWWWW
W-----W---X--------W
W---W-------W---WX-W
W--------------W---W
W------W-------WW--W
W--W-WW-----X--W--WW
W-------W-WWW------W
W------W-----------W
W---WW-------------W
W------------W-W---W
W----------W---WW--W
W------WW----W-----W
W------W--W--X-----W
W---X-WW-------W---W
W---W-------W--W---W
W------------------W
W----X---W---WW----W
WW-X-W--W------W-W-W
WW--WWX--W---W----WW
WWWWWWWWWWWWWWWWWWWW
