WWWWWWWWWWWWWWWWWWWW
W-----W-WW---------W
W----------W------WW
W------------------W
WW----W--------W--WW
W--W---X--------W-WW
W--------X---------W
WWX------W----W----W
W-----------W------W
W---------------W-WW
W--X--------------WW
W------W--W-W------W
W-----W------W---WWW
W-W----------WW----W
W--W--X--W---------W
W--------W---------W
W-XW--W-----------WW
W----------W--W---WW
W-X--------WX-W----W
WWWWWWWWWWWWWWWWWWWW
