WWWWWWWWWWWWWWWWWWWW
W-----W----W-XW----W
W-----W---W-W-W----W
W---W---W--XW---WWWW
W--------------W---W
W--------------W---W
W----X-----W-W----WW
W-----W--W---W-W-W-W
W---X-W-W----W---WWW
W---WW-----W-W--X-WW
W--W--W--W--------XW
W--X-----W--------WW
W----WW---X---W-W--W
W--------W-------W-W
W----W--WW-W-------W
W----W-X----W-----WW
W---W--------W-----W
W-------W-W-----W-WW
W------X---W-------W
WWWWWWWWWWWWWWWWWWWW
