WWWWWWWWWWWWWWWWWWWW
W----W---W--W------W
W--------W---------W
W---W-X------------W
W------------------W
W---WW-W-------XW--W
W-W---WWWW----W----W
W---XW-XW----W----WW
W---WW-W-----------W
W------W-----W---W-W
WX---W-------------W
W----WWW-----X--W-WW
W------W--WW----W--W
W---WW---X---W-----W
WWX--------W--W--X-W
W---W------W--W-W--W
W----W-WWW---------W
W-W------W---WX-XW-W
W-----------W-W-W--W
WWWWWWWWWWWWWWWWWWWW
