WWWWWWWWWWWWWWWWWWWW
W------W----XW-----W
W------W-----------W
W----------W-----W-W
W--XW-----W-W--W---W
W-W--W---X----W----W
W---------W---W---WW
W-W------W---W-----W
W-W---------W-----WW
W----W----W-X------W
WW-----W---W-----W-W
W------------W--W--W
W-----W--W---W--W-WW
W--------WWW--WX---W
WW--W-W-----------WW
W---------WW-------W
W------------------W
W-----W-------W----W
W---X---------W---XW
WWWWWWWWWWWWWWWWWWWW
