WWWWWWWWWWWWWWWWWWWW
W---------WW-------W
W-------W------WWWWW
W-----X------------W
WW-------W------WW-W
W-W------WW--------W
W----------W-------W
W----XW-----W--WWXWW
W----W---W---W-----W
W--W--W----W----W--W
W-X----------------W
W----------W-W-----W
W-W---W--W---------W
W--W----W-----W-X--W
W-----W-----W------W
W--W-------WX------W
W----------W-----W-W
W------W---WW--W---W
W-WW-W---W-WW------W
WWWWWWWWWWWWWWWWWWWW
