WWWWWWWWWWWWWWWWWWWW
W------W-X----W----W
W----W-------------W
W----------WW------W
WWX-WW------------WW
W----------W-W----XW
W--W---W--W--------W
W-W--------W-W--WWWW
W---WW---------W-W-W
W----WW-W--------W-W
W------------------W
WW------W-W--------W
W--W---------W-----W
WW---W-----W----W--W
W--W---W-----------W
W-----WW-W--------WW
W-X-----W-------WW-W
WW----------W--W---W
WW---------W-------W
WWWWWWWWWWWWWWWWWWWW
