WWWWWWWWWWWWWWWWWWWW
W-----X---W-WW-----W
W--------WW--------W
W-----W-W-------W--W
W-------W-------WW-W
W---X-----W--------W
W----------WX------W
W------W-------W---W
W-------W----------W
W-----W-----W-X--W-W
W---W--------X---W-W
W----W--------WWW--W
W-----W---W-------WW
WW----------W-----WW
W---W-W------------W
WXXW-W-W--------W--W
WWW-W-----W---W----W
W----------W-W----WW
WW-------W------W--W
WWWWWWWWWWWWWWWWWWWW
