WWWWWWWWWWWWWWWWWWWW
W--------W---X-----W
W-------WW---------W
W-------X-XW-W-W--WW
W-WW---------------W
WW-------------W---W
W----X-----------W-W
W--X-W-------------W
WW-------WW--------W
W--W-----------W---W
W---------X-X--X---W
W---------W-------XW
W--------W---W--W--W
W---------------W--W
W------WW----W-----W
WW-W-----W------W--W
W--W---W----WWW----W
W---W----W-------W-W
W--W--------------XW
WWWWWWWWWWWWWWWWWWWW
