WWWWWWWWWWWWWWWWWWWWWWWWWWWWWW
W-----------W----------------W
W-----------W----------------W
W-----------W----------------W
W-----------W----------------W
W-----------W----------------W
W-----------W----------------W
W-----WWWWWWW----------------W
W----W-----------------------W
W----------------------------W
W-----------W----------------W
WWWWWWWWWWWW-----------------W
W----------------------------W
W----------------------------W
W----------------------------W
W----------------------------W
W----------------------------W
W----------------------------W
W----------------------------W
W----------------------------W
W----------------------------W
W----------------------------W
W----------------------------W
W-----------------X---------XW
W----------------------------W
W----------------------------W
W-----------------------X----W
W----------------------------W
W-----------------X---------XW
WWWWWWWWWWWWWWWWWWWWWWWWWWWWWW
