X--WW----WW-X---X-X-
-------XX-X--XWXWXWX
W----W--XXWX-W-XWX--
-----W-W-XX--WXW-XX-
X----W----WX--XXWX--
XXWX--XWW---XXWXXXW-
XW-X-W--W--XW-X--X--
-WXW-W---XWX---X----
-W-WX--W-WXWX-W---WX
W-W-WX---XWX---X----
WX-X-W-XXX-XWXWXXWXX
W--W-XXX--XWWWXW-X--
XWXW-XXXW----X----WX
XW-WWWXWX-XW-X---XXX
XWX-X---WXXW----X--X
--XW-X-X-WX--W-W-XW-
---XW-WW-W-XX--X--W-
XX-WWX-X--XWW-X-XXWX
-X--WWWX-W--XWXXXX--
XXXX-XX--X--X-XX----
