W---WX-X-X-X--WW-XX-
-----W-XXXW--XW--XW-
-----XXW-X------X-W-
X-----WX--X-WWWXW-XW
X-----W-XXX-WX--XW-X
X--XWWX-X-XX---X---X
X-WW-XW--XW-XWX-XXXW
XX-W-WWXWWW--WWXWX-X
-W-XX-WXXX-WXWX---XX
-WXWXX-X--WXX-XX--X-
X--W----WW-WXW-XW-XW
W-XXWXX--XWWWWXX-WW-
-X-XW-XW-W-X-X---XXW
-XX-XW-WXXW-W-XW--XX
--X---X---W-XWX-XWXX
XW-WX-X---WXX---X--X
--XXW-XW--XXXWW--W-X
W----X--W--WXW--W-XX
XX-XW---XX-----X-XWX
XWX-------X--W-X-WXW
