X-XW-XW-XX--X-X--WX-
X----WXX-WX-X--WW-W-
-----W-XX-X-XX-WW---
X-----W-X-XX-XXX-XW-
------XX--W-W-X-WWW-
XWXWW-W----XW--W-WXW
-X-----W-X-X----W-WX
WW-X-XWXX-X--WX-WXWW
XX-----WX-WX-X---XX-
-XX-WX-W--WXXW-WXXXX
-W-XWXWWWW-X-XWX-WXX
--X-XWW--W-W-WXX---X
X--W--XXW-XXX--XW--X
WWXXW--WX-X-X-XX--XX
--X---X-X-WXXW-WWXXX
-XWX--X-W-X-XW----W-
XWW-X-X-W--WXXWXWXXX
-XX--XW--XX-W-XW-WXX
WXXWXW---XXW-W-X--X-
-X-W-WWXX-XX--XWX--X
