WX-XWX---X---X----X-
X------WXWXX--XWXXW-
W-----WWXWWX--XWXW--
-----W-XXX-XW--W-X--
X-----XWXW-W---W-X-X
-X--X--WX-X--W-WXWXX
-X--W--XX----WW-XW-X
---XWX-WX-W-XWX---XX
XX-XXW-X--W--XX-W-XW
XW---W-XW-XX-W-XWWXW
XWX--XW-XWXX-X-X---W
XWXX--W-W--WX--XXWXX
WXXXXW---XXWX--XWWXW
-X-W-W-XW-WW---WX---
-WXW-WWWX--X--X--X-W
X-W-X-W-WX--X-XXX-XX
X-WXWXWX-----WW-XW-X
W-WW-WXWWXWX-X--WX--
---XWXWXX-------XWX-
WWWXX-----X---W-XWXW
