-XX--WW-W--W--------
-----W-XWX-X-W--XWX-
------X----W--------
X-----W---X--W--WXWW
-----XW-W-W--WXW-X-X
X--XWXX-WX-WX--X-X-X
WX-XW--X-WXW-XXWXXXX
---W--W-WXXWW-XWW-XX
-X-X-X------W-XWXX-X
WW-X--XX----XWXW-XWX
XWW--XX--WX-----X-XX
-X--W---XW-X-XX-X-XW
-W--XX-W-XWXWXWW-XXX
WWWWX-X-W--XX--WXXWW
X-X-X-XXX-WX-XW-X---
-XXXW-WX-XXWWXW--X--
-X--X--------X-WWXXW
-XXWXX--XXW-XW-WWW-X
WWWXXXW-XWX--W-X--X-
XWW----X--W---X-X-XX
