X-X--W--W--X-X-WXXWX
X----WW-WWXXXX---X--
X----W-WW-WW-WX-XW-W
W----X--X-X----XW--W
W----XXXWX-WWW--XW-X
WXW--X---W-----XWW-X
XWWW-W--X-X--XW--XW-
WX-W-XWX-X-X--WXXWXX
X--WWWWW-W-W----X--X
-WW-X-----X-XX-W-WXW
---X---WW-XXXXX-WWWX
XX-XWWWWWW-XX--W----
-XXX-X---X---X-X-XX-
XW-X--XWWXXXXWXWXXWX
---XWXWXWWXXX--W-X--
XW-X-WX---X--X-XX---
-XW-XXWX-XXXW-X-XXWX
-W-XWXXWXXW-X-X-X--X
XW--W-WX---X-X-XXW-X
XXX-X--XX-XWW-XX-X-W
