--XW--W--X-X-XWXW-W-
X----W---WX--X-X----
X----WXWX--W-X---XW-
X-----X-WX-WWXXWWXW-
-----WWWXXW-WXWXW--X
X-XWXXW-XXWX---X-XWX
XX-WXWXXX--XW-XWXX-X
WXX-WX-XX---WXW--X-X
-XWXWXWX-X---XXW-W-W
X-XX-XXXW-WWX-X----X
XX-XX-XX--X----XXX-X
--XXWXW---WWXWWXWXXX
-WWXW-WW-XWXWXWW--X-
-X-------W---X--X-XW
XX-XXX--XX----WWXXW-
--XXW---XW---XWW-XX-
W--W--WX-XWW-WXX---W
XX-XWX-WX-WXX--W-X--
XW--X-WX--X--X--W-XX
-WX-XXWX-X-X-WX-XX--
