WWWWWWWWWWWWWWWWWWWW
W------------------W
W------------------W
W----------WW------W
W------------------W
WW------------W----W
WWW-----------W----W
WW------------W----W
WW-----W---W--WW---W
WW---------W--W----W
W----------W--WW---W
W----------W---W---W
W----------W------XW
WWW-----------WWWWWW
W------------------W
WWW-----------W----W
--------------W----W
-------------------W
W-------------------
WWWWWWWWWWWWWWWWWWWW
