XWWW-XWX--X--WW-WXWX
W-----XX--X--X---WX-
-------WX--XX-W----W
-----X--XX-XXX-----W
X----WXXWXXWX-X-XW-X
--XW--WX-X--WWW--XW-
X-X-XX---XXW--X--XX-
X---XX-WXWWX-X----W-
XX-XXXWX-X--X-WW-WWX
XWXWWW---W--X--WWXX-
X--X--W-WXW----WXXXW
-W--XW---W--X-WXXW--
--WXWXW-X-X--XWXWWX-
X---W-WW---X--X-----
-XWX---XWWX-X-XX-XX-
X-XX-X--W-W-W--W---X
-W-WX-XWXX-XW--WW-WX
--WXX--W-X--X-XW-X-X
-W-W-XW--XWX-X-W---X
----X-X-XX------XWW-
