-X--X---X--X---X--W-
------W-----XW-X-XWX
-----W-WWW-WX----X-X
-----X-XX--XXX-X-XWX
-----X---WW-X--XX--X
W-W----XX---WW--W-X-
--X-XW----X-XX-X---X
-----X----------X-X-
WWX-------X-WWWXW---
-WXXXXW---XXX-X-X-X-
--X---WXWX----W---X-
X--XX-W--XW------W-W
-------X--W-W-XWX-WW
---X-W-X-----X-W---X
X-XXWXX----W---X---X
-X----XX-X---XXX--WX
---X-X---X-W-W---WWW
-XX-WX--WXXXW-XX-WX-
WXXX--X-XX--XWXX---X
WX-XX-WXXXXX-XW----X
