-W-X-WW-W--W--W---XX
-------------XW--WXX
X----XW-XWXX--XWWXX-
-----WXXWXWX-XWX-WXX
W-----X--WX--X-W-X-X
XXWXW----X-W--XWXWWW
WX---XXWXW--W-WW-XWX
XW----W-X-XW---W--XX
WXWX--XW---XX--XW-X-
XW-XXX-W-XW-XXW-XXW-
WX-WXW-WWXW-XX-X-X-X
W-W--X-WX-X--X-WX--X
-X-X----X--X--XW--XX
XWXWW-XX-X-WXXWX-XXX
-XXWXWW-X-X-X--XW-X-
WWWXWW-WW-WXWX-XW-WW
------WXX--X-XX-W-W-
--XWWWW-WW---W-X-X--
--W-WXXW--XX-W-XXX-X
-XX-XW-W-WXWXW---XX-
