XW-WW--X----XW---W--
-------W-XW--WX-XWXX
------XX-XX---W-XX-X
X----X-W----X-WW--XX
W-----XWX-X-W-WX-W--
-X--WXXWXWXX-X-----W
XW--X-X-XWXW-XXWX--X
-X-XWXW--XW---X---XX
WWX-XX---XXWWXW--XXX
-XW-X--XXW-W---W-X-X
---WX-WX-X--X--WXWXW
X------X--W-XX-XXWXX
WXXWXXW-XXWWWXX-X--W
W-W-WX--W-WX-XXXW-XW
----WXW--XWW-W-X-X-W
XWXWXWWXW--W--XW-XXW
XWX-WW-W-X-----X--XX
-W--XW-WX-X-XW-WX--X
--X-X--W-----X-X----
X--W-WWWWXX----XX-X-
