W-WWX-XX---W--XW--XX
X------XW--X--X--XWX
X----X---W--XWX-XXXX
X-----WW-WXWXW--WXWW
X---------XW--XXX-XX
WX-XXX-XXXXW--X-XW-X
W-XWX---XXW-WWX--X--
W--XX-W--XW---X--WXW
XW-WX--XW---XXW--XWW
-XWXWXW-XXXXW---WXX-
XX-X--W--X--XWW-X-X-
--X-WW---X-W-XX--XX-
-WXX--WWXXW-WWXX-XXX
X-X-------X--XW-XW-W
W--X-WX----XX---WXXW
-XW--WXXWWXWXX-W--WX
X-X-----W--XXWWXXX--
-XX--WX-W-X-XW---WX-
XW---XWX-WX-X--XX--W
------X--WXX--WXX---
