XX-XXXX--XX-X-X----X
X----X-X-WW--WW-WWXW
X-----XW--WW--X-WWXW
W----X--X-----XWWX-X
W-------XW-XXXWX----
-X-X--X-XXW-WXW--W-X
-XX--WWX-X---XWX---X
X--W-W--XX--WW-W-WXX
-XXW-XWWW-W--X-WW---
X-X--XX-X--XXWXX-X-W
-XW--X-X-X-XXXW-W-XX
XXWWXW-WWWXX-X----XX
XW-X---WXXX-----XXXX
XX--XWXXX-WX-WW-WX-X
-XWXW---X-XXWWXXXX--
W-X--WWXXW-XXX-XX-W-
---X-XX-XW--X-XW--XX
-XW-XW-XX-X---WX-X-X
W--W-----WWW-WXW-X-W
XX----XW--XW---XX--X
