WWWWWWWWWWWWWWWWWWWW
W-----------------WW
W------------------W
W------------------W
W------------------W
W------------------W
W-------------W----W
W-------------W---WW
WW------W----------W
WW-----WW----------W
WW-W---------------W
WW-----------------W
WW------W-W--------W
WW-W--------------XW
W------------------W
W---W--------------W
WWW-W-W--W---------W
WWW-W--------------W
W------------------W
WWWWWWWWWWWWWWWWWWWW
