--XX-X---X-XX-X-X---
-----XXW--X-XXX-----
X-----X-X-------XWXX
-----X-X--WWXX-X-XX-
-------X-X---XWWX--X
W-X-X--X--XW---XW---
-X--XX-X-X-WX--W-X--
-W--XX-X------X-WW-W
W-X--X-WX-X-W---W--X
-W--X-----XX-W--XWW-
WX---X-X--W---X-WXX-
XWXX-X-X---XX--XX-WX
W-XX------WWX--XX---
------XXWXW---X--W--
X-X-XX--XXX-X------W
--X----X--X-XW-W--X-
-----X-X--X-XXW----W
X-X--XX---XX-XXWX--X
------W-X--X-XX-WX-X
XXXX--WXX--XXX-WXX-X
