XX---XXX---WX-XX---X
X----W--WX-XW--WW--X
W----WXW--W-WW-XW--W
X-----WXXWX--WX-----
X----X-XWXW-W----WXX
W-X-WWW-XW-X-XWWXWXW
XXW--WWXW--W--W--W-W
-XW-W-X----X--WXXX-W
WX--W-WX-WWW-WWWXW-W
XX--WWWWXW-X------X-
XXW-W----X---WXX--XX
X--XXX-XW-W-XWW----X
-W---X----XWWXWXWXX-
XW-WX-WW--XX--W--WWX
-------WX-X--X----XW
----WWW--X-----WWWWX
-XXX-XW----W-X------
-XWWWW-XW-XX--X--XWX
XX-----WXWXX-X-XXX-W
W-XX-W-XW-X--XWW-X-X
