XWX-W--X--------XX-X
X----WW--X-XWW-XWWXX
-----X-XXWXWXWXXWWWX
W----XXWXX--W-----X-
X----WX-X-X-WXW--W--
X-W-XX---W--WXWX-WW-
---X-XWXX-X---W----X
---WX---XW-XXX-XWXXX
W-XXWWX-X-X--WXW-XW-
XX--X-----W-X--W-XXX
XWXXXX--X-W-XX-XXXWX
XWW-WW--X-XXXWXWWXW-
XWX-XXW-XXXWX--XW---
---XW-XX-XX-W--WX---
XW--W--XX-XW--XXX-WX
X--X-X--W---W--WWXWX
-XW-WW-WX-----X----X
-WX---XX--W-X-XX--XX
-X--X-W-WX---X----XX
-XWXW-X--WXWXX-W-XWX
