XWX-WW-W--WX-XWXXXX-
X----W-X-W--WX---X--
-----XXW--XW-----XXX
X-----X----WXWXWWWXX
X----XW-W--WX-W-X-W-
WXW--WX--W--WX--W-XX
WX-W-XWX-WXWWWW--WX-
XW-WXX-XXXX--WW--W--
-XXWXXWXX---X-XWXXXX
XX----X-XWWWWWWX-X-W
X--WX--XXW-X-XW-WWWX
XXWWXX-WWWXX--WXWW-X
W-WX-X----W-WW-X-XXX
----XX---X-----X---W
--XW-XWXWW-X--XWWW-W
---X--XW-X--XWXWXW-W
XW--X-----WWX-W-W--W
X-XX-WXWW-WX-----WXX
------W----XWX---WWX
--W-XX---XX--X----X-
