-X--W--XWWX-WX--X-W-
W------X-X---XW--W-X
------W----X----XW--
------X-XX----XX-WX-
X------X---WW-WXWX--
-------WXWWX--WXW---
-X--WXX--XX-X----X-X
WWW-XX-X--WXX------X
WX------W-XWWX---WX-
-XX---X----X-WX-XX--
-X---W-X--X---XXX---
XX-W-X-W--WW-X--XWWX
XX---X-----XX--X-X-X
WX--W-XW------X-XW-X
X-X--WWXX--X--X---X-
---X-X--X------XX---
X--WWXX-XWW-X------X
W--XX-X--W-X--X--WXX
X-X-XWXX-X-W-X-----X
-X--X-XX-XW--X--XW-X
