-X-X-WW-XXWW-WWXX---
-------XXXX------X--
X------X--XX-XXW---X
------XX-X-X-W------
W-----XXWX-WXXX-XXXX
XX---X-X--WW-WXWXW-X
--XWX-----W-X-X-X---
XWXXXX-WWX-WWX-X-WWW
XXXX-XXXWWX-WXXWXXW-
X-XXX--WXXX-WXX----W
XWW-X--X--W-WXX-WX-W
X-X-X---WX-XW-XXXXWX
X-X-W--X---X-XXXX-XW
--WW-X-WXXX-WX-XX--X
-XX--X-XWX--WX-XWX-X
-WX--W-WXXWXXXWW-XXW
X-WW-----W---X-----X
WXXX-XWX---X--XXX---
X--W--XWXWXXXWW-W-W-
--X-X--X--W--XX---X-
