XWW-XWXWXWW-XX--X-X-
X----XX--W----WXXXW-
X-----XX----X--XW-WX
-----WWX-WXWWWX-XXXX
X------W--XXW-WXW--X
XX--X---W-XWX-X-W--X
--X--X---XXXXX--X-XX
-XWXX-WX-WWWXXW-XXXX
---XX-XXX-XW-XX--W-X
-W-XWXXX----W----WX-
XWW-XW-XWXX---XW-XXX
X-WX-W--WX-X-XXW---X
--X---X-XWXWXX-W--XX
--W-XX-XW-XWX--WXXXX
-WX---X-W--X-XX---W-
--W--XWXWXW----WXX-X
-XW-XXWX-W-XWX-X-XW-
-W--XW--XXX--WX-X---
X---X-X-WW-X--X-----
--X-----W-WWXXX--XWX
