WWWWWWWWWWWWWWWWWWWW
W------------------W
W------------------W
W---------W--------W
W------------------W
W--------WW--------W
WW-------WW--W-----W
WW-----------------W
WW----------------XW
WW--------W--------W
W-WW---------------W
W-W----------------W
W------------------W
W------------------W
W-----------------XW
W-W---------------WW
W------------------W
W------------------W
W------WWW---------W
WWWWWWWWWWWWWWWWWWWW
