-XXX-XWX-W-WW----X--
X-----XX-X-XWX-X-XX-
-----WXW-W--WX-X-W-X
-----XX-XWXX---X---W
-----XXX----W---XXXX
W-WW-WW-W-WWWWXX---X
XX-XWXXW--WX--XXXXXW
----W------WXWX-WX-X
XX-XWX-X-XW-WXX-XX--
-WXXXW--WX-XXWWX-XX-
X--X-XX----X----XWXX
XX-XW-XWXW-XWWWWXXW-
W-XW--XW-----W-WW--X
XX----X-XXW---WW-W--
W-XWXW-X--WW-X--XW--
-WXWWW---X-XX--W-XW-
X-X--W-XXWXX-W-WXWWW
------XWXW-X--WWX-X-
WX-WXW-X--X--XXXX---
W-WXWWXX-X-X-XXXWX-W
