WWWWWWWWWWWWWWWWWWWW
W------------------W
W------------------W
W------------------W
W------------------W
W------------------W
W-----W------------W
W-----------------XW
W------------------W
W------------------W
W------------------W
WWW---------------WW
W------------------W
W----------------X-W
W------------------W
W-----------------WW
W-----W------W----WW
W-W----------------W
W-----------------WW
WWWWWWWWWWWWWWWWWWWW
