WWWWWWWWWWWWWWWWWWWW
W------------------W
W------------------W
W------------------W
W------------------W
W--W----W-------W--W
W--W----W----------W
W-------W----------W
W-------W----------W
W------------------W
W------------------W
W------------------W
W------------------W
W------------------W
W------------------W
WWW----------------W
WW-----------------W
W------------------W
W-----W------------W
WWWWWWWWWWWWWWWWWWWW
