XW-X-W-XWXW-X--X-XXW
-----WWXX---WWWWWWWX
X----XXX----W--X--XX
-----XWXW-X-XXXXWXWX
------W--WWXWWXWW---
WXX-XX---X-------XWW
XWWWWWWW---X--X---XW
X-X---XWXXXXXX-XWWX-
--X-W--WXWW---X-X-X-
WW--XW-X--XW-XWX-X--
-----X-WWW-XXXWX-XW-
X-WWWXX-XW--XWWW--X-
-WWW--X-XX-XXWWW-XWW
--WX-X-X-WXXX-X-W---
-X-W-XWW-XWXWXWX-WW-
WX--X--W--XX----W-WW
-X--XX--XW-X---XW-WX
-XX-X-W-XX---XX--WXX
-XXX--X--WXWXW-WX-XX
XX----XXX--X-XW-XXXW
