XX-WX-X----X----W--X
X-----X-XXXWWWX-WW--
-----X-WWWW---X--W-X
X-------XX-XXXXX-W--
------XWX-XWXX-X-X-X
-WWXXXXXXW-XWX-W-WXW
XXXXXXWXX---XWX--X-X
X--WXWWWX-XW--XW-XXX
X---WW-XWX--X--W-X-X
---WX-X-X-WXXX--X-XW
W-X-X--X--XXX--WXW-X
XXXXWX-XW-XW---XWX--
XXXW-XXX---X--XWX--X
-XW-WW---XX-W-WX-WX-
------X--X-W-XXWW-W-
XX--XWXW-X--WX-XW-WX
XX-W-XWW-XX-X-WW--XX
-X---X-XW-XWW-WX---W
----XWXW-X-W----WWWX
-W-XX---W---XW---W--
