W--X-XWX-X--XW-XW-WX
-----WXW-----X------
W-----XWXWXX-WXXWXW-
------WWX-W--WW-XX-X
W----WW-XWW-X---W--X
XW----X---X---W--W--
X-X-WWXXX--XX-WXWX--
X-W--WXW-X-WXW--X-XW
--X-XW--WW-X--W-W-XX
-W---WWW-X----XX-X-X
X-XWXW-WW-WX-XWXXXXW
X---WXXXWWWW-XX--X--
WW-W-WX-WX--WX---X--
-XW----WWX-X--X-XXXX
WWWXWW-X-X---X-XXW-W
XX-XXWWXXWXW-WX-X--X
---W-WW-XW-XW-XXX-X-
W--XXWWXXW--X-WXW-WX
X--WX----X--W---W--W
WXXXXXXWXXX-W---XXX-
