WWWWWWWWWWWWWWWWWWWW
W----------------W-W
W------------------W
W------------------W
W------------------W
W------------------X
W------------------W
W------------------W
W------------------W
W--------------X-WWW
W-----------------WW
W--WW---X--------WWW
W--WWW--------W-WWWW
W----W--------W-W-WW
W----W-------------W
W-------------W-WWWW
W---------W--------W
W---------W--------W
W-------WWW-W------W
WWWWWWWWWWWWWWWWWWWW
