W-XW--W---WWXXW-X-X-
-----X-WX-WXWX--W-W-
------W-XX-X--X----X
X------X-XW--W-X-X--
X----WXX-X-XWXWWXW-X
-XW-X-XX--XX-W-X-WWW
WWXW---W-X-X--X--WW-
XWW-WWXX-XXWXW-X-XXW
X-W-XXX--X-X---W----
X-XX-XXW------XWXWX-
-XXXW--X--XX---XXXX-
-X--XW-WXXX-------X-
--XX-XX-XX-WW-XXX-W-
-XXXWW-WWW---X--W-WX
W-X---WX----W--X--W-
XXX--WXXWWXXXW-XW--X
WXXX--WWWW-XWW-X-X-X
--WWXX-----X-WXXXWXW
WX-X-XWX-XWXX-X--W--
X-X-XWW-XWXW---X--XX
