WWW--W-XWW--WWXW----
-----X--WWW----X-X--
W----------XWX-XW-X-
X-----W-X-XX-W--WX-W
-----XXXX--W--XW--XX
-XX--XW-WXW-XXWX-XW-
WW-XX--X--XWWXWWXXW-
XW-X-XWXW-------XXXX
-XXX-WXXX----WXXWW-X
-XWWW-WXW-X--XW-X---
-XX--X--WWXWWXXWXX-X
WW-XX-WXWWXWWX--XWXW
X--W-X--W--WX--WW-W-
WX-XW-X-----X-----X-
WW-WXXWX---WWXWX-XX-
-W-WWXX-X--XXXXWX--W
-W-WXW-XXX-XX-XX-XX-
XWW-WWW---XXX-X-X-X-
-XW---XWX-XXW-X-WXW-
-XWX--XXWX--XX-X--W-
