-XX-WXWX-X--X----X-X
W----X-------XX--X--
X-----XX-WWX--WX-XX-
X----WXWWXW-XWWWXWXW
W------X-X----XWXX-X
W-W--W--XX--WW--XW-X
X-X----W--X-X-W-X---
WX-W-W--X---XWW-XXWW
W---W----XWW-WXX-XWX
XWXWWWW-W-WW-W-XWWW-
XWWWWXX-X-XW--X-X--X
WXXW-X-XWWW-WW-X-W-W
-X---WXWWW-W-XW-X--X
-X-X-WWX-WWWXWX--X--
XWXWX-WWXXW-W-XWXX--
WX-XWX-XW--XXXXWXXWX
-W--XW---WW-XXW---XW
-XW--X-----XXWX-XX--
--XWW-XX---XX---XXXX
X----X---XXX--WXX--X
