WWWWWWWWWWWWWWWWWWWW
W------------------W
W------------------W
W--------WW--------W
W------------------W
W------------------W
W------------------W
W----------W------XW
WWW--------W-------W
WW---------W-------W
WW-----------------W
WW-----------------W
WW---------W-------W
WW---------W-------W
W------------------W
W------------------W
W------------------W
W------------------W
W-----------------XW
WWWWWWWWWWWWWWWWWWWW
