--XWW--X----WW-W-XWX
X-------------W-X--X
----------XX-W--X--X
X----X--X--X-XW-XW-X
X-----X-XW-WXXXX-XXX
XWX-W-WXW-XW-WX-XWXX
X-WWX-W---XWX-XW-XXX
X--X-X-W-XW-WXWX--WX
---XW-WW-W----------
-XX--W---XW-X-XX-XXW
XXX--XXX---XWWWWX--X
-WX-X--WXXW-X-X---X-
X-WXW--W----XXX-XWXX
--XX-XW-XWWXW-XW--XW
W-XXXXXX-XWW--WWX--X
X-XWXW-X--XXWX--XXW-
X-W--WW-----XW--XW-X
--X---W----W-WWWW--X
W--W--X-W--WWWX-XW--
-X-WXW-WWWXXX-W-XWX-
