X--XW-XW--XXWWW-----
W---------WW--XXW--X
W-------W-X-XX--WX-X
W----X--WXW-XW---WXX
X----W-W-W--WWW-XX-X
-X---W-XWWWXX---XXX-
--WX-XWXXXW-WXW-XWX-
W--XXW-W-XXX--W--XW-
XWX--X--W---X--XW-X-
XXXX--WXXXW-WXW-XXWX
XXXW-WX-XW--W-W-XXWX
WXW---WX------WW-W-X
XX--WWXW-XXXWXWX--X-
------WXXW-XW--W-WWW
-WWX-XW-XX-X-XWXXX--
X-XX-W---W---X---X--
-X-X-W-W-W-X--XXW-XX
W-XWXWXWXW----XW--XW
-W-WX-WW-X---X--X--W
--X-----X-XW--XWXXXX
