WWWWWWWWWWWWWWWWWWWW
W------------------W
W------------------W
W---------------W-WW
W------------------W
W-W-----W----------W
W------------------W
WW-----------------W
W------------------W
W--W----------W----W
W------------------W
W------------------W
W------------------W
W-W----------------W
W-W----------------W
W-W----------------W
W------WWWW--------W
WWWW---------------W
W------------------W
WWWWWWWWWWWWWWWWWWWW
