XXX---X------X--XX-X
X--------XW-WWXW-W--
X-----XW---X-W--X-X-
W----W-WXW-XX-XW-XXX
-------WX-X---XXWWXX
X-X--XX-W-XXW-X-X--X
-XX--XXX-XW-XX--XX-W
W-XW-XXX-X---XW--WWX
XXWWX--W-XX-XX--XW-X
WX--XX--XX-XWX---XWW
XW--WXWXW---XXXXW--W
XW-XW----X--XXWW--W-
--XXWW-W-----W-WX-X-
X-W----W-XWWX-XWWWXW
WXX-X--XW-XXX-X-WX--
X-WXXW-WX---X-XWW-WW
X--X--X-XW--XX---XW-
W-WX-WXXW-XX----X---
X-XX----X-XXX---XX-X
XXX-XX-XWXWX-XXXXWXX
