X--XXX-WW-WX--------
W------XXW-XWWWXWXWX
W--------X-X-W--W--W
-----W-W-X--WX-X---W
-----X--X-X--X-W-XW-
XWX---X-XW-X-X-XW-WW
X--X--WXXW-XXW-WX--X
-X-WX-XWX-W-X---XWW-
XWWXWX--W---WWX-----
-W--XX-W-WWXWWWXX-WX
--X--X-W-X-XX--XWW-X
--X---XX-XXXWXWWWWXX
-XX--WXWXXX---W---X-
WWX--XW--XW--X------
XXWWXW--WXWW-WW-XWXW
WXXWXXWWWXX---W--W-X
WX-WXW-X-XWW-WWXXWXW
-XW---XWXXW---WXW-XX
-XX-W--XX---X-WXX-X-
XX---XX--X-XWX---XXX
