--------XW---XX--X--
W-----X-W-X-WWXX-W-W
W------WX--XW-W--W--
W----XW---XWX-W---XX
------WXW-XW-XW-WXW-
X-W--XW--X-W--W----X
X--X--X-X----X-W-XXX
X--XX-XWXWXWXW-XX--W
--WXWXXXX---X----WW-
--XWXX-----XW--XW-XX
X--XWX--WXXWXWWXXW-X
-XX-X--W--XWWW---W--
X-X-W---XWX--X-XX-WX
-XX--X-XXWXWWXXWWWWX
XX--X-XXXWW-XW-X-W-W
X-WX-W-X--------W-XX
WWXW-----X-XWWWXXWXW
--X-X-X--X-XXWXXW---
----XW-X--X-W--X----
WWWW--X-XXX-X-WX-XX-
