-X---XWX----X-XW----
-----XXW-X----XX----
------XWWWW--X-WXW--
-------X-XWWX-X-WWXX
-----W--W-WX----X--W
--W-------W-XWX--X--
W---X-X-X-WXXW-WX-W-
W-X-X-XX----X--W-X-X
X-X-X--XWX--W----XW-
X-XW-W-X-W--XXW-X---
X--------X--X-W-X---
XWWXWWXX-WW-W-X---X-
W------XXXX-XW--X---
-----X--W--X----X---
-----X--X-XW-WW-X-XX
-WW--XXXXXX-----XXWX
--X-X-X-X-WX----XX-X
--WX----X-XX-XX--W-X
W-X---X-X-X-WXW---X-
X-XX-XXX--X-X---W-X-
