WWWWWWWWWWWWWWWWWWWW
W-----------------WW
W------------------W
W------------------W
W-----W------------W
W------------------W
W------------------W
W------------------W
W------------------W
W------------------W
W-------------WW---W
W------------WWW---W
W-W----------W-----W
W-W--W-------W-----W
W------------------W
W------------------W
W------------------W
W----------W-------W
W------------------W
WWWWWWWWWWWWWWWWWWWW
