XWX-----XW--X---XWX-
X----XW-X-X-XWW-XX--
X----XX-XXWXW-X--WX-
X----XWWX-----XWX---
-------X--XXW-XXX-X-
X-X--X-XX-WXWX---WW-
X--X--XWWW-W-X-W--X-
X-X-XWW-X-XXXW---XWW
WW-X--W---W---WW--W-
-X--X---XWXX--XXX-XW
XXWXXWXWXX----W-X--X
W-XW-W-WWXW--XWXWXX-
W--X-W-XWW--XWWW-XWX
-XW--X--X---X--WXXX-
WW-XW-XW-WXX---XW-WW
-XX-X--XX----WX--X--
WXWX--X--X---XWXW-X-
WW--W---WX-WW-X-XW-X
W-W-WXXWXWWXXW---XXX
-W-XWXX----X--X----X
