WWWWWWWWWWWWWWWWWWWW
W------------------W
W------------------W
W------------------W
W----------W-------W
W----------W------XW
W-W----------------W
W-W----------------W
W-----------------XW
WWW----------------W
W------------------W
W------------------W
W------------W-WW-WW
WW-----------------W
W------------------W
W------------------W
WW-----------------W
WW-----------------W
W-------------W----W
WWWWWWWWWWWWWWWWWWWW
