--W---X-----XWX-----
------W--XWXXXW--XWW
W----XWWW-XWXWXXW-X-
X----X--W--X-W--W-XX
X----W-W---------XW-
X-XWWWWXXWX-WXXXXWXW
-XX-XXW-WXXWXWWX-X-X
X--XWXWX-WWX-WXW--XX
XW-X--XX-W--WX-WWWXX
W-X-X----XW------XX-
X---XXWWW-W-X---XWX-
W-X-XW-XW-WX-WWXWXWX
WWWXXXX-XX-WW---X--X
W----X--XX--XX-XWXWX
XXX-----XXX--XXW-W-X
W-XWX-WXXWWXWX-XX--X
X-X-X-XX-W-XX-W-XXX-
XW-WXXXW--XW-XWX---X
-XW---X--WX----XXX--
X-X-XW--XXX-XX-WX-X-
