W-XXXW--X---WWXX----
W------XX-W-X-X-XXX-
-----W--W-WXXWWXWXXW
X----WXXX--XX-X-WX--
X----XWXWXXX---W-X-X
-X--WWXX-WX-X--X-X--
XXW--WWXWWX---W-X-X-
-XW-WXXW---XX-WWXWWX
XW-X--X-XWWWXXX-X---
-X-X-----XX-X-X-X--X
-WXW-X-WX-XX-XWXXXWX
X---XWXW-XXWXWXW--XX
W-W-WWW-XX--X--W---W
WWWXX---XX----XWWX-X
--X---W-----XWWWW-XW
--XX--XXX---XWW--XX-
XXWWXW----XW-XX-W-XW
X-X--X-X-XX-XW--XXWX
WXX--WWWXWX-XXWWXX-X
X----X--W---X-W----X
