WWWWWWWWWWWWWWWWWWWW
W------------------W
W------------------W
W------------W-----W
W------------------W
WW-----------------W
WW-----------------W
WWW-W--------------W
W------------------W
W-----------WW-----W
W------------------W
W-WWWW------------WW
W------------------W
W------------------W
WW-----------------W
W-----------------WW
W------------------W
W------------------W
W------------------W
WWWWWWWWWWWWWWWWWWWW
