WWWWWWWWWWWWWWWWWWWW
W------------------W
W------------------W
W------------------W
W------------------W
W------------------W
WW------------W----W
W------------------W
W------------------W
W------------WW---WW
W------------WW----W
W------------------W
W------------W-----W
W------------W-----W
W------------W-----W
W-W----------------W
W------------------W
W------------------W
W-----------------WW
WWWWWWWWWWWWWWWWWWWW
