WWWWWWWWWWWWWWWWWWWW
W------------------W
W------------------W
W------------------W
W------------------W
W------------------W
W------------------W
W-----------W------W
W------------------W
W------WW----------W
W-------WW---------W
W------------------W
W------------------W
W------W-----------W
W------------------W
W------------------W
W------------------W
W-WW-------W------XW
W------------------W
WWWWWWWWWWWWWWWWWWWW
