WWWWWWWWWWWWWWWWWWWW
W------------------W
W------------------W
W--------W---------W
W------------------W
W------------------W
WW--------W-W------W
WW-----------------W
WW-----------------W
WW----------------XW
WW-----------------W
WW-----------------W
WW-----------------W
WW--W-------------WW
WW----------------WW
W------------------W
WW-----------------W
WW--------W--------W
W-----------------WW
WWWWWWWWWWWWWWWWWWWW
