WWWWWWWWWWWWWWWWWWWW
W------------------W
W------------------W
W------W-----------W
W------------------W
WWWW---------------W
W------------------W
WW-----------------W
W------------------W
W------------------W
W------------------W
W------------------W
W----WWWW---------WW
W------------------W
W-----------------XW
W-----------------XW
W------------------W
W------W-----------W
W--W---------------W
WWWWWWWWWWWWWWWWWWWW
