WWWWWWWWWWWWWWWWWWWW
W------------------W
W------------------W
W---------WWWW-----W
W------------------W
W------------------W
W------------------W
W-----------------XW
W-----------------XW
W------------------W
W------------------W
W------------------W
W------------------W
W------W-----------W
W------------------W
W------------------W
W-----------------XW
W------------------W
W------------------W
WWWWWWWWWWWWWWWWWWWW
