-WXWWWWWX-XWXW-WWXWX
X--------X--XX-W--WW
X----XX-X-X----XXX--
X----W-WXX-WXWWXWXWX
X----WWW-X-X-W-XW--X
X---X-W-XX-XW-XW-W--
-X---XWXW-X--X-WWWXX
--XX-XX-WW------X-XX
XX--XXWXW-W--XW-XX-X
-X-WX-XWXXWW---XXXW-
XX-WX-XWWXX--WXWXW--
W-W-W-WXX--W---X--X-
---W---W-XWWXXWWX-W-
---XW--XW--XX-W--W--
-X-XXW-XW-XWWX-XX-XX
-W-WXX-X-X----XXW-XW
XWXWXXX---X--X--W--W
--X-X-X-XW-WWXWXWWXW
W-X-W-X--XXXX-XX--X-
XW--X-X--X-XXX-XX-XX
