X-XW-X---W----W---XX
X-----XW---XX--W-XWX
X----X---W-XWX--X-XX
X----XWWWWX-XX---XW-
X-----W-----WXW--XXW
XW-WX--XWWWXXW-W-WW-
X-XXW---XXX-W--W-WXW
XWXWX-XW-XX-----XW-X
XWWW-XWXX-X--XXXX---
-W-XW-X--X--X--XX-XW
-X--X------XWX-WW-XW
WXXXW-WW-X-XXWXWW-XW
XWWWW--W-WX-X-----WW
-------XXX--WWXX--WW
X-XXXXWXXWWW-X--WWXX
XX-XX--XX--X-XWXWWXW
-W--WWW--WX--WW-XXXX
X--WXXWXW--WW---XW--
---X-X-X-----W----XW
W--XX-X-WX-XWXWX----
