X---W---X-X-XW----WW
X----W--WW-WXX------
W----X---W---WW---WX
X----WX-WWXWX-W-X-W-
------XX-W-W-X-X--WX
W--WX-WX--X--X--X--X
W-WXWX-XX---XWXXXWWX
X-XW-XW-X--XXXW-XWXX
WXWXWXXX-XXXXX--W--X
X--X-X-WX---WW-XWWXW
XX-W-X-X-XWXXX--X--X
XX-WWX-XX-WXW-WW-XX-
XW-X--WW-W---XW-W-X-
-XX-X-XX-XX-WXW--X--
W-XX-W-XX-XW--WWWX--
-XW--X--WX-XX--XW---
--X-WX---X-XW-X---WW
XW-X--W--W---X-XXXWX
XXXWX----X-X--XWXXW-
X--XX-X-XW-XX--XX-XW
