-X-XW---X-X-W---W--W
--------X-X-----WX--
-----WW-X--WX-X-X---
--------X-----X-X-X-
------XX---WWX---XX-
-X-X-XWWX-WX----WWWX
X----------W-XX-X---
XXXX---XW-WXX-W---X-
X--WXXWXWXXX-----XX-
--XX--XX-W-XWXWWXX-X
WW-X-X-X-XXW------XW
W-X-XX------W-XW-XX-
---X---X-X-WX----WWW
-W-W-WW-XW-W--------
XW-X------XW-X-X----
-X-XW-WX-XW-X-------
XX-W-W-XWX---X--WWX-
-XWXX--X-W----X-XW-X
-XW---------WX--X--X
-X-X-X-X---X--X-XX--
