WWWWWWWWWWWWWWWWWWWW
W------------------W
W------------------W
W------------------W
W------------------W
W------------------W
W--------W---------W
W-X------W--------XW
W-------WW---------W
W-W------W---W----WW
W--------W---------W
W-W----------------W
W-W---------------XW
WWW-----W----------W
WW----------------WW
W----------W-------W
W---W-----------W-WW
W---W-------------XW
W-W-W-------------WW
WWWWWWWW-WWWWWWWWWWW
