WWWWWWWWWWWWWWWWWWWW
W----W-------------W
W----W--WWW----WWWWW
W----------W-------W
W----W---WW----WWW-W
WW---WW--W------W--W
W----WW------------W
W---WWW--W------WW-W
W------------------W
W--------W-------W-W
WWWWWWW------------W
W------------------W
WWWW--W-----------WW
W------------WWW---W
WWW---------------WW
W----------W-WW--WWW
WWWWWW---WWW--WW-WWW
WWW--W-----W-WW--WWW
WWW-------WW-WWW-W-W
WWW--WWWWWWWWWWWWWWW
