X----WX-WX---X-W--W-
X--------WXX-WWWXXX-
-----XWXXWX--X-XWXX-
X-----X-X---X--XX---
X----X-XXW-W-X--W-WW
X-WXX-X---W-X-X--XX-
XXW-XX-X-XX-WXXXXXW-
WX--X-WXW-WX-WXXXX--
-X--X-XW-X----X---XX
-XX-XXW-XWX-XWXWXX-X
-WXXXWW-XWW-WX-XXX--
XWW--X-WW--XW-XXX--X
XX--X-XXWX-W-WXXXW--
X-X--XXW---XWWXX----
XWWXX-----X--XXW-XWX
XW-WX--XW-WWW-W---XX
-X-X-X--W-XX-W--XX-X
X--X-XX-W-W-X-W--XX-
-XWX--WW-X----XX--W-
-WXWXX-XWXW--W-XX--X
