X----X-X-X-XW--X----
X----XXXWXXWW-WX-X--
W----X--XWW-W-XW-XX-
X----WX-XX-WXWXWX-XX
X-----XX--WXWXX----X
---XW-X-X---XXW-----
----W-WXWWXW-XWW----
-WWW-XW--X-XW--WX-X-
--X-WX-X--X---WX-W--
XXWXXW-W-XW-W-WW--XW
XX---W-XXW-XW-WW--WX
X-X-X-XX----W--WW-XW
WX-XW-X-WXX-WX--WWWW
-WWXW-XW-W-X--X----W
-X--WXW--WW-W--WW-W-
XWXWXWWWXWWXWW--X-W-
X--XWX-WXWXXW--W--W-
XWXXWXW--W-XWX-WWXW-
X-W--WWW-XWXWWXWW---
XX--X-XW--W--W-X--W-
