X---X-W--WX-XW-W--WX
X-------X-WXWXWWX--X
X----XW-X-WWX----X-X
------X--X--X-WXWW-W
X----XW-XW-WXWW-W--X
XWWXXXXW-X--W-XXW--X
W---XX-X-W---XWXXW-W
W--X-X-XXXXW-XX-----
WW-WXX-W-WW--W--XWXX
-W-W-X-W--W-XXW--XXX
-XXXWWX-XXW---WW--XX
XXXXXW-WXX-WX-WXX-W-
---WW-WW---XX---WX-X
--X-W--WWXXXWXXX-XWX
-W--WWWWXX-XWW-XWX--
-X--X-X---X--XX--XX-
-WXXXXXX-X-X-XWXWWWW
--X--WWXX--X--X--X-X
XXW-W--X---XXWXXWW-X
XXX--X-------X----W-
