X-WXWXX----WXW-XWX--
-------W-XW--X-W--XW
-----X--W-W-X--X-WWX
-----WXXW-XWXWWW-W--
X----X--WX--W-XX-XWW
-X---WXW--W-XXWXWW-X
--X-X-WXW-W-WW------
X-XXX--XW--XW-WX-XWX
WWX--W---XWX-W-X-WWX
-X---WX-WWXW-X-W-X--
WXX-XW-XW--W--XXWX-W
XXWXXW-WXW--WX-XWWWX
X-W--W-X-----WX---XX
-X--XX--X--X-X-XWXWX
-WX--XX--W--XW-WX--X
XXWXX-WX-WX--W--XX--
X-WXX-WXX---XWW--W--
W--X--X-X-WWX-----WX
--X--WXXW-----WWXWXX
X--XWWW-X---X--X-XW-
