X-X------X-XW-WW-WXX
W-----WW-XW-XX----XW
X----W--W-X-W-WX---X
X----X-----W-W-WXWW-
X----XX-WX--W-XWW--X
W----WXX-XXW-X-XW--X
--X--WXW-----XX--X-X
---XXX-W---WXXW--XXX
-X-XX-X-WW-XXW-W-W-X
XWXX-XX-X--WX-X-XXW-
-XWXX-WWW-W-W-XWX---
--WXWX--W-X-W---X--X
XWWXWWW-XWWXWXX-WX-X
--W-XXWX-XWX-WX-----
XXWW-W-X-W-XX-XWXXXX
W--W-WWX--XX-XXWXWXW
XW-X-W-XWXWXW----WXW
---W-WXWX-XX--WXXX--
-XXX-WXX-WWWX-XWXXW-
X--WX--XW-WXWW-WX-XX
