WWWWWWWWWWWWWWWWWWWW
W------------------W
W-------------W----W
W------------------W
W------------------W
W-------------W---WW
W------------------W
W------------------W
W------------------W
W---W------------XWW
WW-----------------W
WW-----------------W
WW-----------------W
W------------------W
WW-----------------W
WW------W----------W
W-------W-------W--W
W------------W--W--W
W------------W--W--W
WWWWWWWWWWWWWWWWWWWW
