W--XW--WWX-XX-X-X--X
------X--W-XW-W--WX-
X----WWXWX-XWXWXW--X
------WW-WW--WWWWXXW
-----X-WX-X--WWWWXX-
XWXWWWXWXX-WX-WXWW-X
WX-XWWX-XX----W-XX--
XX--W--XW---W--WWWX-
-XXX-WX-X-X-WW-XX--X
-XWXX-XX---X---X--X-
-WWX-WX-X-X--XXWX---
-X--X-XX-X-X-WWW----
-----W-WX--X---X-XX-
XXWXW---X-X--XXWW-WX
X-XX-XX-W-WX-XWWXXX-
-XXXXW-XWX-W-W-XXW--
XX-W-WWX--XWWW--X-XW
--XWX-X-XWW-WWX-XW-X
-XW-WXWW-XWW--XXWXX-
XXX----X--XW--WX--X-
