-----WX-W-W---XW----
X----X--X-X-XXXXXX--
--------WXWWXW--XXXX
------WWWXW--WWWW-W-
-------XXW--X---W--X
XWW--W--WXWX-XW-XWW-
--WX-X-XXX-XX-WW-X-W
X-XX-W-W-X--X-----XX
XW--WXWXW--XXX--XW-X
XX--XW-XW--XW-W-XX-X
X-------X-X-XW-XXW-X
XXXWXWWXWX-XW-WX--XX
---WXX--XX-W-WWXWXX-
--X-XXX--XWXWXXWWXW-
X--XX--XW--W-X----XW
XXX-X----XWWXW--X--W
W-WX----X--WWXW-WXX-
-W--W--W-W-XX---XWX-
-W--XW-XW-W-XXW--X--
W-X--W-X---X---X--X-
