-XWX---X----X---W---
-----W--X-XX--XWW-WX
-----WX-XXWWWWWX-X-X
X----XW-X-X-XW-WWW-X
X-----WX--XW-X----XX
X-WX-WWXW--X-XWXW--X
-XWWWW-X-X-XW-XXX---
-----W-XW-XX-X--WXXW
X--W--XWWX-X-XWX-XWX
X--W-XWWW-X----W-XW-
X-X-WW--WX-XW-XWX--X
--X--WXX-X--XW-X-X--
-XW-XW-WW-XW-XXWW-XW
XXW-WWXWXWW-X--W-X--
WXX-W-W---X--X-WX-XX
--WX-WWX-XW-WXX-XX-X
--W----WW-XWXWW-----
X-XWW-XX--X-X--WXWXW
W---XW--WX-XX---W--X
-XWX-XXWXWXX-XW--X--
