XXX--X-XW--W------W-
X----WX-XWX-W-XWW-XW
------XXWX------W--X
X----XXWXWW-XXWXW--X
W--------W-X-XW-WX-X
-XX-X---XX-XW-XXW-XW
XXW--WXWWX---W--XXWX
-X-W-WXXW-X--X-W-XXW
---W-XX-X----X--X---
XX--XXWXWXWW-WXXXX-W
-X-XXXW---W----XW--X
XX-X--X--XXW--XX-W--
XW--WX-WWXXX-X---XX-
X-XWXWX-WW-WXXXW-X-X
--WXWWX---X-XX---XW-
XW----X--XX---XW-W-X
XXW---XXW--XX--X--W-
-XX-XX-X-X-W-X--XWX-
--XW-XX--W-WXW-WWX-X
-WWWXWX--WX---X-X--X
