X---XWW--W--XXX-XWXX
W----X-X-X--XXW-WXWW
W-----W---X-----X-XX
W-----WXWXXX--XXXXX-
X----WX--XWXX-XX--XX
X-XWX--WXW-W-XXX-XW-
WWWWW-XX-XWWXWX-XX--
-XXX---XWW-XXXW--XW-
WWWWWX------X-X----X
-W-----XXWXXW-XW-W-X
XW--WXWW-X--WX-WXX--
X---WXW---X-WXX-XX--
XXXW-XWXX-WXWW--XWX-
X--XWWWWW---X--W--XX
W-X-X-X-W---WX-W-WXW
X-XXWWXX---X--XXW-XX
-X--XWXWWW-XXW-XX---
-XW-W-XW-XWXX---X-XX
--XXX--XXXW-XWXWWW-X
X--XX----XX------W-X
