WWWWWWWWWWWWWWWWWWWW
W-----------W------W
W------------------W
W------------------W
W------------W-----W
W-WW--------------WW
W-----------------WW
W-----------------WW
W-----------------WW
W--------W---------W
W-W------W-----W---W
W-----------------WW
WWW------WW--------W
W-WW---------------W
W--W---------------W
W------------------W
W----------W----W--W
W------------------W
W--------------WW-WW
WWWWWWWWWWWWWWWWWWWW
