WWWWWWWWWWWWWWWWWWWW
W------------------W
W------------------W
W------------------W
W------------------W
W-----------------XW
WW-----------------W
WWW---------------XW
W------------------W
W------------------W
W-W---------------XW
W------------------W
W------------------W
W------------------W
W------------------W
W------------------W
W---W--------------W
W------------------W
W-W----------------W
WWWWWWWWWWWWWWWWWWWW
