WWWWWWWWWWW-WWWWWWWW
-------------------W
W------------W-----W
W------------------W
W------------------W
W-----------W------W
W-----------W------W
W---------W--------W
W------------------W
W------------------W
W---------------W--W
W------------------W
W------------------W
W------------------W
W-----------------WW
W-------------------
WW-----------------W
W-------W-W--------W
W---------W--------W
WWWWWWWWWWWWW-W-WWWW
