X--X-X--X-WXWXWXWWXW
W----W-W-XXX-XWWWXWX
X----X-X-----XX----X
X----XX-X-X--X--XX-W
-----XXX-X-X--W-WXX-
W-W----WXWX-XX--WX-X
XX-XWWWWXXXX--XWWXWX
-X--XX--XWX----XWW-X
X--XW-XW-WW-WWXW-WX-
XX-X-XW--X---XX-X--W
---X--WW--WWW-X-W-W-
WW--XX-XXWWXWXWXW-X-
-XXXWX-WWW----X-XXXX
-WWX-X----X-X-XW-XXW
XW-XW-X-XX--WX-WW-WX
-W--XXWXWW-WW-W-XW--
XXXWW-W-XW-XX-W-WX-X
WW----W-X-W-X---WX-W
---W-WW----WW-W-X--X
---W---XW-----WWXW--
