---X----WWWWX-W-WWWX
X----WX-XW---------X
W----WXW----XWXX---X
W-------X-XWW-X-WWXX
X----XW--XW-W--X-W-W
-XW-WXWW-X---W-XXXXX
X-XX--W-XWWWXXXWXW-X
XW-XWW---WW----XWW--
X--XW-WXX-W-X-X--W--
XX---W-XW-W-XXXX-W-X
X-XX--XWWXWXWXX-XW-X
X-WX-XWW--W-XX--WW-X
--XW-X---W--XWXX----
W--XW-WW-XWWXX--X-X-
X-X--X---XWXWXW-W-WX
X--X-XXXXW-XW-WX--XX
WXWXXXX-XW-X-W-X-XW-
XWX----X-XW---XWXWXW
-X-XXX--WXXXX-X----X
XWX--XW--XW--XX--X--
