XW-----WW--X---XW-XX
W-------XWXX----XW--
-----X-X---W--X---WW
-----X--WWW---XXXWX-
W----XW--XX--XWW-WXW
XW--W--XX--WXXX--XXX
-W-XWX----WWWWXW--XX
XWW-XXX--W-W---X--WW
W--XXX--XWX-XW--W--X
--WWX-W-XXXXWW--XW--
X---X--XW-XXXWXXXXX-
---X-W-WWX-XXWX--XX-
WX-XX---W-XX-X----WX
WW-X-WWWXX-X-WW-XXXX
-W-W-WXW-WXWXWWW-W-X
WWXWX---XW--------XW
--------WX----XXX-XX
-WXWXWXWXWWXWXWXW-X-
---------X---XX--X--
----X-XXX---XXX--X--
