-X---XW--X---XWXWX--
X----XWXWWXXWXWXWX-X
-----W--XW---X---XWX
W------XXW----W-WWXW
-----XXX-X--WX---X-X
XW--XWXX-WWXX--X-XXW
WXX-WW-WXW---XW-X-WX
-XX-X-X-XW-X--XW----
XXXWWWXW-XX-X-XW-XW-
XXW--W---XW-X--WX--X
-W-XW---XW-W-X--X-WX
W-WWWW-WXW-X--XW--XW
-W--XX-X-X-WXX---WXX
X-XX-W--XWX-XW--X-X-
XX-X--X----X--X--XWX
WX--XXX-W-W-W-X-XW--
WX--W-X--X---WW--X--
XWX--X----W-XX--W-W-
-XXX-X--X--XXWW-----
XX-WXXW----XX---XXX-
