WX--X-W-X--W--XWXWXX
X----XXWW-X-W--WX--X
-----XWWXW-WW-WXWXXW
-----WW-W---XXX-X-WX
X------X-WW-WXWXX---
XXX-X--X-WW--X--W--X
W--X-X--X---XX--X-WX
-W-XWX-XXXWX--XW-WX-
XW-XWXXWWW--XX--W-XW
-XW----WXWX-X------W
-W---X--XXWWW-WXW-X-
--WXXXWXXXWXW-X----W
XWXWXXWXXW--WW---X--
W-WX--W-XW---W---WXX
W--XW-WX--WXWW-XWXX-
WX-X---X-XXWXWX-W-XX
-W---W-XW-XW----W--X
-WX--W--X-----XWXXX-
W--X--XX-XX-WW-WWXXX
-X---XX------X--X-XW
