WWWWWWWWWWWWWWWWWWWW
W------------------W
W----W-------------W
W----W---W------W-WW
W------------------W
W--------W-W-------W
W--W---------------W
W--W------------W--W
W--W------------W--W
W--W-----------WW--W
W--------X-----WW-WW
W-WW------------W--W
W-WW------------W--W
W-WW--X---------W--W
W---------------W--W
W-----W---------W--W
W---------------WW-W
W------------------W
W------------------W
WWWWWWWWWWWWWWWWWWWW
