--X-X----X---X--X---
X----XW-XWXW--XW-XXX
----------WXW-XXXXXX
X----XWW--XXWX-WX-W-
X-----X--WX-WX--WWWX
XXW--XWXWX-W--XWWX-X
-WX-XWXXXXWWXX-X-W--
W-WX--XWXWX--WW--XX-
XWX-W--XW-WW-W----WX
X--W-W-XXX-X-----XWX
-XW--WX-WXW-XWXWXW-X
X-X-W----XW-W---XW-W
W-WWXWXWXW---X-W--XW
WXW-W-XW---X-WXW-WWW
X-XX-X-XWWWWX--W--X-
X--X-XWW--W--XXWXXX-
WWXXX-W-WW-X-WXW-WWX
XXWW--X-----XWWWXW-X
-X----XWXW-XW---W--X
W--XWX--W--XXXXXX-XW
