---XW--X-XW-XWXX---X
W--------WWWWX-W-WXX
-----XWW--XWX-XXWX--
X----WW-W--XXWXW-XX-
X----WX--XWW-X-X-XWW
---WX--WWXXW--W--XWX
W-X-W----WX---WX--XX
X-X-XW-X-XXX-XXXX--X
--X--XWW-W-XXXX-XX-X
W-X-----X-X--XX-X--X
X-X-WXXXXW-XW-WX-XWX
X-XX-XX-WXW-X--X--XX
XXX-XWXX--X-XX-XXW-W
-XW-WXX-WXXXW-WX--W-
--WWXWWXWXXXX-------
XW-XXXW-W--X---XX-X-
XW-X-W--W-XX-XXWWXWX
-XXXW-X-XX--XXXW-XX-
X--XX-W-XWX------XX-
-X---XW--XW----W-XWX
