WWWWWWWWWWWWWWWWWWWW
W------------------W
W------------------W
W------------------W
W-----------------XW
W------------------W
W------------------W
W----W-------------W
W------------------W
W------------------W
W-----------------WW
W------------------W
W-----------------XW
WWWW---------------W
W------------------W
W------------------W
W------------------W
W-W----------------W
WWW----------------W
WWWWWWWWWWWWWWWWWWWW
