WWWWWWWWWWWWWWWWWWWW
W-----------------WW
W-----------------WW
W------------------W
W-----W-----------XW
W------------------W
W------------------W
W------------------W
W------------------W
W------------------W
W-----W-----------XW
WW----WW-----------W
W-----W------------W
W-----------------WW
W-----------------XW
W------------------W
W------------------W
W------------------W
W------------------W
WWWWWWWWWWWWWWWWWWWW
