WWWWWWWWWWWWWWWWWWWW
W------------------W
W------W-----------W
W------W-----------W
W------W-----------W
W------------------W
W------------------W
W------------------W
W------------------W
W--W--W------------W
W------------------W
W--W--W------------W
W-----W------------W
W-----W------------W
W-W----------------W
W-W----------------W
W-W----------------W
W-W----------------W
W------------------W
WWWWWWWWWWWWWWWWWWWW
