-------XWX-X-WW--X-X
X-----XX-X--WX-W-X-X
X----X-W-XX--X-XX---
------X-X-WX-X--XXWX
X-------XXW--X---WWW
XXXW-XW--X--X-XX-X-X
XX--X--XX--WXXXWXXWX
-X-X---XXW-XXXXX--X-
-WXW---XW-XXWXXWXW-X
XW---WXXWX-X-X-X-XXW
XX---X--X-XWXWW-XW-X
-XXWWWXXXXX---X--X-X
---W-X-X--XX-XX-WW-W
--WXXWXXW---W--XXX-X
--XWX---W-XW-XWXXW-W
W-XW--X-W----W-X--WX
W-----WX---WXX--XWWX
WXXW-X--WW-XWWX-WXXX
XWW--XW--W-WWX-WW--X
XXX----X-X-W----X--W
