-XW-WXW---W--XXWWX-W
X----X---X-XWW----W-
W----XX--WWWX-X-X-XX
-----W-W-WW--XXXWXXW
X------WX-WWW-W--X-X
XWXX-WX-X----WXX-XX-
WX-XXWX-X-X-WWX-X--X
--WXWXWXX-XX-W-XXXW-
--XW--WXWWXWXWX-XW-W
-X--WWWWW---XWWXW--X
XW-W-X-XXWX-XXXX-W--
XWX-WXWXXXW-XXW-XX--
WWW-WX---W-W-WXWXWX-
--WX-WXXWW-WW-WX-X--
XWWXXW-W-X-WX-----W-
-X-W---X--WX-XW-X-XX
----XW--WXWX--X--XWW
XWXXWXXX--W-X--WX---
X--W--XW--XW-XWX----
-X--XWXWWX----XXX-XX
