XX----WW-WXWWW-XX---
-----XX-X-XX--W-W-X-
-----WXW-X-XXX--WX-W
-------W---W--XX-X-W
------W--X-XWX---W--
W------W-X-W--X--W-X
XX--W--W---XWXXXW-XX
WXW------X--XXXW---X
X----XXWXWXX----WWXX
X-WXX-X-XXW-X--WWXWW
-WW-XX-W-----XWW-XW-
-XX----WXW--XW-----X
-WX-XW--W-W-X-XXW-X-
XXWW-WX-W-WX----X--X
WXXWXX-XXXW-W--X-XXX
--W-XXX-XWXW-WW-WWX-
XWWW-XXXW-X---X--XW-
XWXW-W--X--X-W-XXXWX
XW-X--W--XWXXWXWXW-X
--W-XW-XX-X----XX---
