X---W--XW-W--X----XW
-----X--X--X--WWWXX-
W----XXXW-WWXX-XXWW-
X----W--W-XW-----XWX
X----X----X-XW-WXXWX
X---XX--XWXW-XW-X--W
XWXXX-W-W-XX--X--XWW
XWW-WWWWX-WX-W-XX-X-
---XW--XWXWXWWX---WX
WX-XWW-XW--X---X--WX
XX--WW-W-XXX-XXWWX-X
--X-WXXXX-XX-XXW--W-
X-X---X--XX--XXWWW-X
WXXX-XXX---X-XW--XWX
XX-X-XXW-W---W-X-X-X
-WXX-X-----X-WWXWXX-
-WW-X-XXXXXXWW-XWWXX
W-X---XXXXX----WW-WX
XXWXWWX-X--WW-XW----
-XX--XX--X---X----W-
