WWWWWWWWWWWWWWWWWWWW
W--------W---------W
W------------------W
W-----------WWW----W
W------------------W
W------------------W
W------------------W
W------------------W
W-----------W-WW--WW
W----W---------W--WW
W-----------W-WW--WW
W----WW-----------WW
W--W---------------W
W--W----------W----W
W-------W---------XW
W------------------W
W------------------W
W------------------W
W------------------W
WWWWWWWWWWWWWWWWWWWW
