X---X-X-XW-X-X--WXXX
-----W--XW-WXWW----X
X-----X-WW-WXXXX-X--
X----WWXXW-XXW-XWW-X
------X--W--WWWXWW-X
X-W-XX-X------X-----
W--W-X----X-XW-XWWXX
W--XX-X--WXXXXW-W-X-
-WWXX-WXX----XWXX---
--XXW-XXXXW-WXWXXX--
X-XWWX-XW--XWXW--W--
XXX--WX-XW--XW-X-X-X
X--XXX-X-X---X--W-XW
WXX---X--WXXXW--W--X
--XWX-XW-XWX-WXXWX-X
XWW-XX----WXX-XWW--X
-WXX-XX-WWW-W--X--W-
---XXXXXW--XW---XWWX
XWWXX--X--X--WXW-W-X
-XW-XX--W--X--X-----
