-X-X---XXWX--X-XXX--
-----X--X-WW---W---W
-----X--X----X-WXW-X
-------X-----X--WX--
W---------WXXXWXWX--
-XXWX----XX-X----X--
-------X------X-WW--
-WW-W---W--X-W--XX-W
-XWW--WX---W-------X
-XW--W-XX---W--X-X-W
-XWXX---X-W-W-----X-
-W-X-X-XW-X-X-X----W
-XWX-WW--XX-W-XX---X
X--X--X-XW------XX--
WX-W---X----XW-XWX--
-X--X--XX-X-W--X--XX
-X---XWXWWX-X-X-X-X-
W--W----X-X-XX--W---
XXW-XXW------X-X----
WXX-X-XXX--WX-W-X---
