-XWX-XW---W-------W-
X----X----XWX-XW--WX
W-----W-W---W------X
X----WXW-W--W-XXW--X
-------XX-WXWWXXW-XX
WWWXX-X---XX----X--X
X-W-XXWWXX-XXWXW-XX-
-WXXX--W-X---W-XW-XX
X-X-W--XW--X--XXWXWX
X--XWXXXWW-W-X-X-XWX
W-XXX-X--W---WXWXX-X
-W-XWX-X-WXX-XXW-W--
-X--WW-XW-XX--X-WXWW
-WXXWWXW-X-XWX-WXX-X
--W-XX-WXXWX-XW--W--
--X-W-XWXWWXWWXW--XX
X-XX--WX--W-WWWXXW-W
X--X--X--W-WWW--W---
WX---XX--XW-XW--WW--
---X-WXX--XX-X------
