WWWWWWWWWWWWWWWWWWWW
W------------------W
W------------------W
W------------------W
W------------------W
W------------------W
W------------------W
W------------------W
W------------------W
W-WW---------------W
W-----------------XW
W-----------W------W
W------------------W
W------------------W
W------------------W
W------------------W
W------------------W
W---------------W--W
W------------------W
WWWWWWWWWWWWWWWWWWWW
