-W--WXW--W---W----X-
-----WXWXW--W----WXW
-------X--X-X---XW-X
W----W--XW-W-XWXWXX-
X-----XWX-W-W--X--XW
-XX-WXWXWW-XWXW-WX-X
--W--WX-W-X---WXWX--
XW--X-X-XWX--X-X-X--
XXW--X-WW-XW-XXXWX-W
---X---XW--X--X--X--
X-XWXXWX-XX---X--W-X
X--XWXWWXX-X-X-XXX--
-XX--W-W-XX--XW-W---
X--XX--WWX-WX---WXWX
XW-W-X-W-WWWWXWWXW-X
-X-------X--------XW
W-XX----XW-X-XWXWWXW
-XXWX-XXX-XWXWXWW--X
WXX-XX-XW-W-X-XWX---
--X--W--W--XXX--XXX-
