-XXXWX-W-WW--X------
------X-----WXXXW-WX
------X-----WWW-W---
X----XW--XWWWXX--XWX
W-----WW-XW-XWWX-XX-
X--XWX-X--W---WWW---
X-X-XW-W-X-XWXW-WX--
-WWW-WWW-X-W-XW--XXX
WX-W-XXW-W-X---XXXWX
-X-WXXXX-X--XW-WWXXW
-XXXXWXXX----WW-X---
-XXX-----W----W-WXXW
X---X-W-W-WXXX-X-WWX
XW-WX---W-XXXWXW-XX-
X-----XXXXW-W--X--X-
XW-XWX-X-W--WX-XXXWW
-XX-XXX----XXWXW-X-X
WWXW-XXW-XW-WWXX--XX
-W-WX-X-W-XW--XX---X
-XWXXXXX----XWXX-XX-
