W-W-X-X-WXXXW---X---
X----XXX-X-XWW--WXWW
W----WX--WX-XWXWWXX-
-----WX-X-XXX-WX-XX-
-----XWXX--WX-X-X--X
X-XW----X--XX-XWXWX-
W--W-WW-XX-WXXW--X--
XX----X--WX----WXX-X
X-W-X-X--W-WWXWW-XW-
--X--XX--WXWX----XW-
XWWXWXW-X-XXX----X-X
-X-----WX-XX--WW-XX-
-X-X-XX-W-WWW-W---WX
X-X------X-WWXW-XW-X
X-XXXX-XXXWX-WW--X-X
XWXWWWWXXXWW-W-XXXXX
XXX--W-XW--XW--W----
XXWX-XXWX-XWXWXX-W--
XXWW-WW-XWWX-WXXX-XX
---W--W-WW--X-X---XX
