WWWWWWWWWWWWWWWWWWWW
W------------------W
W-----W------------W
W------------------W
W---------------W-XW
W--W---------------W
W------------------W
W------------------W
W------------------W
W-----------W-----XW
W------------------W
W------------------W
W------------------W
W-----------W------W
W------------------W
WWWWWW-W-----------W
WW-----W----------XW
W------------------W
W------------------W
WWWWWWWWWWWWWWWWWWWW
