WWWWWWWWWWWWWWWWWWWW
W-----------------XW
W------------------W
W------X-----------W
W------------WW-W--W
W------------------W
W------------------W
W-----------------XW
W---------------W--W
W-----------------XW
W---W--------------W
WW-----------------W
W----------W-------W
W------------------W
W-W----------------W
W------------------W
W-W--------------WWW
W-W-----WW---------W
W------------------W
WWWWWWWWWWWWWWWWWWWW
