WWWWWWWWWWWWWWWWWWWW
W------------------W
W------------------W
W------------------W
W------------------W
W-----------------XW
WW-----------------W
W------------------W
WW-----------------W
WW----------------XW
WWW----------------W
W-------W----------W
W------------------W
W------------------W
W------------------W
W--------------W---W
W------------------W
W------------------W
W------------------W
WWWWWWWWWWWWWWWWWWWW
