XXWX-XW------W-XWW--
-----XWWX--W-WW-X--X
W------X-WXXWXX---WW
W----W--XW-W-XWX---X
W----WW--X-XWXX--W-X
XW--XXXW-WXWXX-X-XX-
WXX--XX---W-XX-WXWXW
XWW--WXWW----X-X-X-X
X--WW--------XW--WXW
-WW-W-W-W-XW-------X
-XX-XX-WWXXXX--W-XW-
XW---X-XW-XX-X-XW-XX
XW-WWWXXW--X---WXXWX
-WX------W-XWX-XXW--
W-X-XWWXWXX--XW-X-W-
--XXW-WW-WX---XXWWXX
-XXXWX-X--XWXXWXWXXX
WW--XWXW-WWXX--X--X-
WXW----W-WX--XWX--XX
X-XW-XXWX-X---XW--WW
