W-X-WW-----X-----X--
-------WWX-X--XX-XWW
X----W-WX--X--XW--XW
X----WW-XWXWWX-----X
-----WX-X------XX--X
--W-X-WXWW-W--W-XXWX
--X---W-W-W---XX--XX
---X--X-X--W-XW--X--
XXX-WXX-WX--XWXW-X-X
X-X-XXWXWW----W-X--W
XXW-WW-WXW-XXX----XX
---XW-WWXX----XX-WX-
X-X--W-WW-WXXXW-XWX-
-XX--WXW--W-X-XWXW--
WWX--XWXWXX-WX-X----
XW-XWX-WW-WX----XWW-
-----X--X--XX-WX-XWW
WXWXWX-W-XWWWX-XX-XX
-X-W--W-XW-X-W-XXX--
-W-XXWX-X----XX-----
