XW-WXXX-WXX-W-XWX---
X----X---WXX-X--WXXW
-----WWXW---X-----W-
X----X--WXXXWX--X-XW
X-----XX-WW--X-WXW-X
--X-X--------XX-XW--
-XW-W----XWXX--X--W-
WXWW-XWXXXW-XWW-X-X-
XWWXX-XXX---W----X-X
WW-X---XW--X-----W--
----WXW--WWX-----XWX
X-W-WX--WX--W-XXX-XX
W---W--WWW--WX-XX-X-
-XX-XW-XX--X--XW-XXX
-X--XW-WXWXWWX-XWX-X
WXX-XXX----WX-------
W-W-XXXXWX-XXX---XXX
---X-XWXWW--XXWX-XXX
XW---W-X-----X-X-XX-
-WW--W----WX-X-WXX--
