WWWWWWWWWWWWWWWWWWWW
W-----------W------W
W------------------W
W-----------W------W
W-----------------XW
W------------------W
W----W---W--------XW
W------------------W
W--------W---------W
W-----------------XW
W----------WW------W
W-------X----------W
W------------------W
W------------------W
WW---------W-------W
WW-----W-----------W
WW-----W--------X--W
WW-----W----------XW
WW-----------------W
WWWWWWWWWWWWWWW--WWW
