WWWWWWWWWWWWWWWWWWWW
W------------------W
W------------------W
W------------------W
W------------------W
W------------------W
W---WW---------W---W
W---W--------------W
W------------------W
W------------------W
W--------W---------W
W-----------------WW
W-W----------------W
W------------------W
W------------------W
W------------------W
W------------------W
W----W-------------W
W------------------W
WWWWWWWWWWWWWWWWWWWW
