WWWWWWWWWWWWWWWWWWWW
-------------------W
W------------------W
W------------------W
W------------------W
W------------------W
W----------W-------W
W----------W-------W
W------------------W
W--W-----WWW-------W
W-WW---------------W
W-WWW--------------W
WWW-W--------------W
W------------------W
W------------------W
W------------------W
WWW-------------W-XW
W------------------W
W------------------W
WWWWWWWWWWWWWWWWWWWW
