--X--XXWWW-----X---X
X----WXX---W-X---WWX
---------X-X--X-XWXW
X----WXW--WWXW--WX--
------X-W--WWX-W--W-
X--XXX---XX-XX--X--X
--XW-XX-XXXXXW---X-X
XWXXX-W-XXXXX----WXX
XX-WX-XWXX-WWWXWWWXW
--X-XX--X--XW-----WX
XWX-X-X---X-XW-XXWXW
XXWXWXWWX--XWW--WXW-
--W--XX--XX-X-W-WXXX
X--XX---W--W-X-W-WWX
X--X-WW-WXXXWW-W---W
-WXXW-WX-W-X---WW-XX
XW-W-X-XX-W--XXXWW-X
------XXWWXW---X---X
------W-W--XXW--XXXW
---XX---------XW-X-X
