W-X-WW--XX-XWX--XW-X
-----W--WX-X-W--X---
------WX-X--W-W-X--X
X----X-X--X-W-XX----
X-----W--W--WWW-W-XX
X-WXWX-X-W---XWXWXW-
-WXXXXX-WX-XW--W--X-
W-WX---W-X--W--XW--X
W-XW--XWXW---XX-XX-X
WXXXXXWXXW--XXXW-XXW
XW-WXX-X--X-XW-X---X
X---XW--X-XXXWWXX--X
W-X-X-X-X--XW--WWW-W
XX-XW-XXWXXXW---W--X
-XX-X--WWX---X-WWXWW
X-X--X--WXX-XX--XWWX
XX----X-WX---W---W--
X-X-XWXX--W--WX--XX-
XXX-XXX---XXXXXXX-XX
X-XXX--XWX--XXXXX---
