--X-X---WX-X-XW-X-XW
W----X--W---X-XXXW-X
X-----WXWX--XX-X-WXX
------X--WW-W-XX-X-X
X----WW-WXWXX----X-X
-----WXW-XX------XXX
X--XX--W-XX--W-WW-X-
WX----X--XXWX--XXW--
---WXX----X-WX---X--
--WXW--WWXWX-X--X---
WW--X-X----X----XX--
-X-XXW-X---X--X-X-X-
X---X-XW----X-X--XW-
XXXXX----XW-X-X--XXW
X-X-------X-XWWX---X
X--X-W-X-X-WX--WWX-X
-W---XWXXW-----XXX-X
---W-----X-X---W-WX-
XW-XW--X-WWWX--X-X-X
---XX----X--XX-W-X-X
