----------X-X-XWX---
-----XX-XWX-X-XXWXWW
X----W-XX-XX-XW---W-
-----W--WX----X----X
X--------W-X-X--XXWX
--WWW-W------WXW-WXX
-WWW-X-XWWXX-X-XW--X
WWW-X-X-XW-W-XXXW-XX
X-WWWWX-X---W-------
------X----XXWXX-WX-
XWXWX-XWXW-XX-XWW-XX
W--XW-X-XWXXX-X----X
--X-W--X--WXW--W-XX-
X-X-WX-XW-X-----XXX-
XXXWX-X-WXW---XW-XWX
WXWXWX---X---WX-XWXW
X-WWXWX--X-X--WWX---
-X-XWWWX-WWXWX--WXX-
-X--XW---W-X--XXX---
X----W-WX-X--WWXXXXX
