WWWWWWWWWWWWWWWWWWWW
W------------------W
W------------------W
W------------------W
W----------W-------W
W-----------------XW
W----------W-------W
WW-----------------W
WW-W---------------W
W------------------W
W------------------W
W-----------------XW
W------------------W
W-----------------XW
W------------------W
WWW----------------W
W---------W--------W
WWW----------------W
WWW----------------W
WWWWWWWWWWWWWWWWWWWW
