WWWWWWWWWWWWWWWWWWWW
W------------------W
W------------------W
W------------------W
W------------------W
W-W----------------W
W------------W-W---W
W------------------W
W-----------------WW
W------------------W
W-W----------------W
W------------------W
W----WWWWWW---W----W
W------------------W
W-W---------------XW
W------------------W
W------------------W
WWW----------------W
W------------------W
WWWWWWWWWWWWWWWWWWWW
