-WW------W--X-X-XX--
X-----XW-WXX--WXX---
-----XWW-W-X--WXX--X
-----X---X---X-W-WX-
X----W--XWXW-XXWW--X
-XWX-X--WW--WXXX-XW-
X--XW--WXXXWX---WW-W
--X-XWXW---X-W-WWX--
X-WXXW-WW-XWX-XX-XXX
WXW-XW--XXX--W-XX--X
X---XWWXWXWW-WW-XX--
W-XWX-WWXWWW--WW-W-X
XW-WW-WX--WW--XW----
XW-WX--XX-XWWW-XW-W-
-WX--XW-W--X-W-XX-XW
---X-WXX-XX--XX-W--X
XW--X---X-XWWXXXWX-W
W-X-X--WWXWWXWXX-XX-
W-W--XWWXXWW-X-X---X
-XX--WXW-W-W-W-----X
