WWWWWWWWWWWWWWWWWWWW
W---------W--------W
W------------------W
W----------------X-W
W------------------W
W------------------W
W------------------W
W------------------W
WW-W---------------W
W---------W-------XW
WW-WW--------------W
W------------------W
WWWW---------W----XW
W-----------WWW----W
W----W-------------W
W------------------W
W------------------W
W-----------------XW
W-------X--W-------W
WWWWWWWWWWWWWWWWWWWW
