WWWWWWWWWWWWWWWWWWWW
W------------------W
W------------------W
W------------------W
W------------------W
WWW----------------W
WW-----------------W
W-W----------------W
W------------------W
W-W-------W-------WW
W-W-------W-------WW
W---------W--------W
W------------------W
W---------W--------W
W--W---------------W
W--W---------------W
WWWW---------------W
W------------------W
WWWW---------------W
WWWWWWWWWWWWWWWWWWWW
