----W-WWX--W--W--X--
X------X-X--XX--WXW-
X------XXWWWWX---W-X
X----XX-W-XW-XWWX--X
X----X--X--W--WWXWXW
XW-WX-X-W-X-XW--W--X
--W--X-XW---X-WW---X
X-XWWW-XWX------W--W
W-XWWW-X--X-X--X---X
-X---X--X--W-XX---X-
----W-X--X-XX-X-XXXX
-XW---X----W---WWXXX
---W--X-WXXXWW-WXWX-
X--XWX-XW-X----X-XW-
-W-X-X------W-XW--X-
-X-XX--WWWWXW-XXX-X-
XWXWXXXWW-X-WXXWWXWX
X-W-X-X---W--W-X--XX
--X-XXWWWXX--W-XXXWX
X-XX-X--W--X-X--WXXW
