WX--WX-WX-XX-XX--XX-
X----XW-WXXX-X-W--XX
X----WX--X-W-XWW--XW
W-------WX-WXW---XWX
-----W-WWXWW-WW-X-X-
X-XXW-WWXWX-X-XWXWWX
XW-W--WXX--XXW-XXWW-
----X--XXXW-X-WXX--W
X---W-XXW---X--WW-WX
--W-WW-WW-WXWXWW-XWX
XWWW--X---XWX--W--WX
-XW---X---X-WX--WX--
-X-WWXWWWX-XWWXWWXWX
X-XWWW--XXX---W-WX-X
X------W--XX-X-X---W
XXX-WWWXXW-WX-XW-W--
WWX-X---W---XW-XX--W
-------XX-X--WWWWWWX
XX-W-XWWW-XWW-X---XX
-W---XX---X-XXX-W-XX
