XX-XXW-X--W--W--XWXX
X------XX-WXWXWXX-X-
X----WXWXW-WW-X----X
X----WXXWW-XW--X-X--
-----W-XX---XXXWX--W
WWXX-XX---XWX-XX-X-X
XWXXW-X--WW-X-X----X
--WWW-X---X-XX-W-XWX
W-XXX-XW-X-XWX-WXXW-
W-W-WXW-X---X--XX-XW
-XXXW--W---X---XX-X-
W--XX-XX-W-WW-X-----
XXX-XWXW-WX---XXW-XW
WXXWXWX-XW-W----X-W-
------XW-XW-X-X----X
-WX-WXWX----XWX----X
-X-WX-XXX---X-X---XW
--WW-X--X-WX--X-WXX-
XW-WW-W--X-W--W-XXXX
-X-WXW---XX-W--X-XWX
