WWWWWWWWWWWWWWWWWWWW
W------------------W
W------------------W
W------------------W
W---------------W--W
W------------------W
W------------------W
W------------------W
W------------------W
WWW----------------W
WW-----------------W
WW-----------------W
WW-----------------W
WW-----------------W
W-----------------WW
W------------------W
W--------W---------W
W------------------W
W------------------W
WWWWWWWWWWWWWWWWWWWW
