---XX-X-WW-XW-------
X----W--XX--XX--W-WX
W-----X-X-XX-WWWWXXX
X-----XX-XXX--WW--XX
W-----WW--XXWX-WX-WX
-XX-XWX-----XWWXWX--
-WWWWXX-X--XXWXX-X--
X--X-X-W-X-XWXXWXXWX
--WWXWWWWWXWX-X----X
-W-W--X--XWXW-WXX--X
WX-XW---WXX---X---XW
XXX--WWW-X-XWXXWX-X-
XXWX-XX-X-WWWWW---X-
X---X-X-W-W----W--XX
----XWXXWXXXWXW--XX-
-XW---X-X-XWXW--XWX-
X-X-W-XW-XWX--WXXW-X
XXWX-XW-XW---WWW-WXW
W--------XWWW--XWWXX
---W--XXXW---W--XXXW
