WWWWWWWWWWWWWWWWWWWW
W--------------W-W-W
W------W-W-----W---W
W------------W-----W
W------W-W---W----WW
W-W------W---W-----W
W-W----W-W---WW---WW
WWW----W-----------W
W-----------W-----WW
WWW-------W-------WW
W----W-------------W
W-W----------------W
W---W-W--W-W-----W-W
W------------------W
WWWW---W-W---W---WWW
W--------W---------W
WWWW-----W---------W
W-----------------WW
WW-----W-----WW----W
WWWWWWWWWW-WWWWWWWWW
