WWWWWWWWWWWWWWWWWWWW
W------------------W
W------------------W
W--------W---------W
W------------------W
W-----------------XW
W------------------W
W------------------W
W------W------W---XW
W------W-W---------W
W------------------W
W---------------W--W
W------------------W
W------------------W
W---------W--------W
W------------------W
WWW-----------W----W
W-W-----------W----W
W------------------W
WWWWWWWWWWWWWWWWWWWW
