--W----XW---X-X-----
X-------X------X----
W-----W--X---X--W---
X-------XW-X-XW-X---
---------X----WXW-X-
W-----X---WXX---X-X-
W-X-WXXX--W---X-X-X-
W-X--WX-X--WXWX-XWWW
---X--XWX---WXX--XX-
X-X-W----X-W--XXX-X-
--XX----X--X-X-X-XWW
XWXW-XXX-X-X--X----X
WW-XX-X---XX--------
---XX-X--XX-X-XX--WX
--X---------X------W
W-WX-WXX------W-X---
-XX-X---XW---W------
W---X-WX-W----WX-W--
--X-XW--XXWW--X---W-
--X--X---XXXXX-X----
