WWWWWWWWWWWWWWWWWWWW
W------------------W
W------------------W
W------------------W
W------------------W
W-W----------------W
W------------------W
W-------W--W-------W
W------------------W
W-------W----------W
WWW----------------W
W------------------W
WWWWW--------------W
W------------------W
W------------------W
WW-----------------W
W-----W------------W
W-----------------WW
W------------------W
WWWW-WWWWWWWWWWWWWWW
