X------WX--X-WX--X-X
-----WXWXXXW-W-X--X-
X-----X-X-XX---XX---
-----X-XX---XXWXXX-W
-----WX-----W-X--WXX
W-W-WW--XWX-XXX--WXX
WX-XWWXWXW-XW-XXWX-W
WXWWXW-WWXW--XW-----
WX-XX-X-X----XW-WW-X
X-XWX-WX-X---W-WXWWX
XXW----WX--XW-W-XWXW
WXX-WX-X-W--XXWWW-WW
X-X-----XW-X--WWXWXW
-XX-WX-WXX--W--XWXW-
-XW--W-X---X-X--X-W-
WXW--WW-----W---X-X-
X---W-XW---WWXW--X-X
XX--X---WWXWX-X--WXX
X-X-XWXWWWW--W-W--XX
X--X--WX-XW-WX--X-XX
