X--WX-XWX--WXWWWXW--
------XX--XW-XX----X
-------XW-X---XWXW--
X----W--W-X-W-WWXWX-
X----XX-W-X-X-XWXXW-
WX---XW---XWXXW-X-WW
XXWW-XWW--W-----X-WX
-X--XW-WW-WWW-XW-W-X
-XW-WX-XW---WW-X-X--
X-XWXXX--X--WWXXX-X-
X-WW-WX--XWW-X-WWXWW
--XW-X-W---W-XWWW-X-
W-WXX-W---X-X---X--W
----XX--XXW-WX-X-X--
X-X--WWWX-XXW-X-X-X-
XWXWX---X---XWX-XXX-
X---X--XXXWWWWW---XW
XXWXWXWWXXWWXWWX-X-X
W-WXW-WX--XW-XWWW--X
-WW--X--XX--X----W--
