--X---XWXX--W--W--XX
X----XW-WWWWW---WWX-
-----XW-----XWW-WXW-
X-------XW-XWW-XW---
-----WX-XWW-XW-X-XW-
X-XWXWX-XWWW-XX---W-
X-X-X--XXW--WW-W-WXX
WXW-X--X--W-W----X-X
---X--W-X-WWXX-WX-XX
W-----X--W--XWW-WWXX
X-X-W--W---WXW---XWW
-WWWWXX--WW-X----WX-
--XXX-WW---XWXW-XWX-
XW-WXX---XXXX-X--XX-
WXX-XW-WX-----WXXWX-
XW--WX-XW-X-X--XXX--
-XXWXXXW-X-W---XX-XX
X-W--WX---X-----XX-W
---XW----X--W--XXX--
-W--XX---X--X-X-XXX-
