X--W---X--X-XWXW-W-W
X-----X-XWWWW--X----
X----WW-XX--XX--X--W
------W-XXXX-XW-X-XX
------XXW--WWW---WW-
-XX---W--X--XW-X--XX
XX-W-X---XXX----XX-X
XX--WX---X-W-X-XWWXW
XWX-XX-XW----WXXW--X
X--XW--XX-X-X-XXX--X
-X--XX-XXWXX--XXWXXX
-XWWWWWWW--X--XX-WWX
-X--X---XX--WX-X--XX
XWXW-X---W----X-X--X
XW-XW-X-X--XX-XW--W-
WXXW--WX-X--W-XWWXW-
XW----X---XWXXXW-XXW
--XWX--XXXW-XX-W-X-W
W-X-W--WX------WX---
XXX-XW-XW-WWXWWXW-W-
