--WXWXW-WXXWXXW-WXW-
-----W-X-XW-X-X--W-X
--------XX-XXXWX-XWX
X----XX-XX-XXWXW--XX
X----WWXWXW------XXX
----XW-XX-XXXW--X--X
-X--W-WXWXWXW-X-WX--
--XWX--XX--W----WXWX
X-XXWXXX--XW-XWX-W-X
XXX--W----W-XWX---XW
-XW-WXWX--WXXXX-XWXX
X--WXW-XWWX-XWX-W-W-
-W-X--XWXWXW-------X
----XXX-WWXWX-XWX-WX
-W-WWXW-XW-WX--XW--X
-WW-W--W-WWWWX-XWXX-
X----------X----XXXX
-WWWWWXXXXX-X--XWXWX
---WWXW--W---W--X-WX
--W-WWXW--W---X---W-
