WWWWWWWWWWWWWWWWWWWW
W------------------W
W------------------W
W------------------W
W-----------------WW
WW-----------------W
W-----------------WW
-------------------W
WW-------W--W------W
W------------------W
W--------W---------W
W------------------W
W------------------W
W-W----------------W
W----W-------------W
W----W-------------W
W---------W--------W
W---------W--------W
W-----------------WW
WWWWWWWWWWWWWWWWWWWW
