WWWWWWWWWWWWWWWWWWWW
W------------------W
W------------------W
W-----------------WW
W------W--W--------W
W---------W-X------W
W---------W-------XW
W------------------W
WWWW------W--------W
W---------W----WWWWW
W---------W--------W
W---------WWWW-W--WW
W-WWW-------------WW
W------------------W
W------------W-WW--W
W-----------WW--W--W
W------W----WW--W--W
W---W--W----------XW
W------------------W
WWWWWWWWWWWWWWWWWWWW
