WWWWWWWWWWWWWWWWWWWW
W------------------W
W------------------W
W------W-----------W
W------W-----------W
W------------------W
W--------W---------W
W------------------W
W------------------W
W------------------W
W------W-WW--------W
WW-------------W-WXW
W------W-----------W
W------W-----------W
W------------------W
W------------------W
W-----------------XW
W------------------W
WWW----------------W
WWWWWWWWWWWWWWWWWWWW
