WWWWWWWWWWWWWWWWWWWW
W------WW---------WW
W-------------------
W------WWWWWWWWW-WWW
W--------W---W-----W
W--------------WW-WW
W-----W------------W
W---------------W--W
W--------X---------W
W----------W------WW
WWW--------W--W---WW
WW----------------W-
WWW----------------W
W------------------W
W--W---------------W
WWWW----WW-----WW--W
W--WW---WW---------W
W-------WW--W-------
W---W--------------W
WWWWWWWWWWWWWWWWWWWW
