-XXX-XW--W-W--WXWXXX
W----WWWWWXWXW-W--XW
------XW-------X-XX-
-----W-X-WW-XXXXW-XX
X----XWWXWXX--WXWW--
XX----XWWXW------WXW
X----WX--X-W-X-XXXXX
X-XX--X-XX-WXXXWX-W-
XW--XX-XWX--XXW--XXW
XW--WW--X----XW-XX-X
X---X-XWW-XW---XW-XW
X-XW-WWXWW-XWW-XXXXX
WX-X-W-XWXWXWXXXXX-W
-X-WX--W-WWWW-WXXW-X
-W--XX-WXX--W-X-WW-W
--XX-XXXX-W-XW-X-WX-
XX-X-XW-X-WW-XW-XW-X
W--XX--X-X--X--W--WX
-X--XX-XW---WX-X-WXX
--XW-----X-XW--W-XXW
