-X---WXXXWW---XWX-X-
X-----X-X----W-W--WW
-------------WXX----
------X----X--W---W-
--------WWW-----W---
X--XXXXWX-X-X---W--W
X---W--X-X-WX-XWXXW-
X-WXX-XWX---W--W-X-X
----XW---X-XXX---WXX
---X-X-WXWX--W--W-W-
-WXWXW---X-XWXW--XX-
W--WW--X-X-X---X-X-X
XW-X-WX-XXWW-W--X--X
X---X-W-X---W-XW-WX-
X--X--X-XXW-X--XX---
XXX--X--W-X-W-XWW-WX
WX-XWX--X---X--X--XX
--X---X----WX-X---X-
XWWXW-WX-X-XXWW--X-X
W-XXXX-----X---X---X
