WWWWWWWWWWWWWWWWWWWW
W------------------W
W------------------W
W-------W----------W
W-------W----------W
W---W--------------W
W------------------W
W------------------W
WW-----------------W
W-----------------XW
W------------------W
WW-------WW---W----W
W------------------W
W------------------W
W------------------W
W-------------W---WW
W------------------W
W------------------W
W------------------W
WWWWWWWWWWWWWWWWWWWW
