---X-W--X-WX---W----
-----XWWWX-XX--XW-XX
X----W-XX----XX---XW
X-----WWXXW--WX--XXW
W----XWX--WW-WWWX-W-
X-W-X-W-X--WWXWXW--X
XWX-XW---X-XW-WXWX-W
WX-WXWX--WW-XX-W-XX-
XXX--WXX-X---X--XW--
X-WW-W-X---XW--WXWWX
-XW-X-W-XWXW--WWXW-X
XW--XWW-W-XW---W-X--
XW-XW-W-X-W-XW-XWWWX
W-WWX-W--XX-XWW-WX--
--WX-XW---WXWX-W-X-X
-XWW-WXW---W-W--XW--
XX-W---XXW-X-WX--XW-
XWXX-W--XXWW-X---WXX
-XXW-W---X-W-WXX-X--
-X-X--XX--------XXXW
