-W---W-W---W--W-XWW-
------X---WW-X-X---X
-----WWWW-X-X-X-XW-X
-------WW-X-XXW-XX-X
W-----XXXW-XWX-X-X--
-WXWWXWWXW--XX--XXWX
XW--W------X-XXW-XWW
XXW-WW-W-XWXXX------
XW---X-X-XXW----WW-X
-X---W-W-XX-X-WXWWWW
-WXXXXXW-XXWXXW-W-XX
--X-XW---XW-XX--X--X
XXXXX--X---WWWWW-XX-
X-XWX--X--WXXWW-XWXX
W-X--XWW-XW----X-XX-
X---WX-X-----WXXX---
-X---WWX-XWXX---WXX-
W-WX-W---W--X-X-WW-X
X----X-----X-XWXX---
-XX-X-XWW-X-XWX--W-X
