-WXWX---W-WWX----X--
W------WW-------W-WW
X-----W----XWWWWXW--
W-----W-XWWXX-W--X--
------WX-X----XWX-XX
--XWWW-W---XW--X-WW-
XXWXW-WW-WWX-X-XW-XX
XX----XW--X---XXW--X
-XX-WXW-XWXXXXX-XWXW
WWXXXXWWXX-XXXXWWWW-
X--XW--WX-XX---XW---
--X-W---XW-W-X---XXX
------WX-X---X-WXWW-
--XW-XXX---W--XX-W-X
XX-WX-X-W-XWWX-W-W-W
X-X-XW-W-W-W-X--WW--
XW-XWXWXW---XX--X-XW
-XW-XWWXW-WWXX--X--W
--W-----W-WX-W--XX--
XX---W---WWWX-W-XXXX
