WWWWWWWWWWWWWWWWWWWW
W------------------W
W------------------W
W------------------W
W-----------------XW
W------------------W
W-------WW---------W
W------------------W
W------------------W
W-----------------XW
W--------------WW--W
W------------------W
W--------------W---W
W---------W-W------W
W-----------------XW
W------------------W
W------------------W
W-----------W------W
W------W-----------W
WWWWWWWWWWWWWWWWWWWW
