-W-X-X-X-----X---WXW
-----XW-WX-W----X-X-
W------X-WX-X-X-W--X
-------X--WXWXXX-X-X
X----X-X----X-WXX---
-----W-----X----X-W-
X--XWX--X-W--WWX-X--
----X-X-----XWX-X-X-
-X---XWWW----XWWW--W
-XX--XXWW---XW------
X-W--X---X-W-W-WWX-X
X--W-X----XW-WWX-X--
X--XWX-XX--XX-XW-XW-
WW-WX---X---WX---XXW
WX--X-W--W----XW-XXX
WXW-----X----XXX-X--
W--XX---XWXX-WX-----
X-XWXW-X----W-WXW-X-
-X-XX---WX--X-----X-
X----X---XX-------X-
