----XW--XW---W------
-----WWXX------X--WX
------W--XXWX--WX-XX
X-----X--WXWX--XW--X
W----X--X-XW-W--WW--
-XXWXWX-X--WX-X--XX-
X-W--WX-X---X--XXXXX
XXW----X--X---XWXWW-
W---X-WWXWXXWXWX-WXW
W-WXWXW-WW--X-WXX-W-
XW-X--X-XXW-XX-X---W
-XX-X---W-------XW--
---XXX---XWXXW-X-XWX
-WXWXWXWX-XWWX--X--X
W-WXXWXXW-----X-WXXX
WXW--------WWW-X-XW-
-X-X--W--XXW-W-W-WWX
XW-WX-W-WWX--XW--W--
-X----W--X--W-XXW-W-
X--X----W-X-WX--X-WX
