WWWWWWWWWWWWWWWWWWWW
W------------------W
W------------------W
W------------------W
W----------W-------W
W------------------W
W------------------W
W------------------W
W------------------W
W------W-----------W
WWW----------------W
W------------------W
W------------------W
W------------------W
W------------------W
W--------------W---W
W------------------W
W------------------W
W-----------------WW
WWWWWWWWWWWWWWWWWWWW
