W--XWX---X--XWX---WX
-----W-XW-X-W-WWW--W
X----X-X--WXX----X--
X----W-XXXW--X--XWXX
-----X-X-----WXWX---
XWWW-XXWXWXW-WXX--XX
-WX-WXXW---WXWXXWXXX
X-XWWX--X---XX--X--X
--XW--X--XWXX-W-XX--
-WW-W-W---XWX-XXWWX-
W---X-W--X-XWW-XX---
WXX-XXWX-WXWXWWWXXXW
WW-WXX--X-W--X--W-XX
W---XW--X---W-XXXXX-
W-X-XXW-XXW-WXWXWXX-
XX-XW-XX-XXX-X-XX-X-
X-X-XX-X-XWXXXX-WXX-
X--WXX-WX-WW-WXX--WX
-X--X---X----X---W-X
--W-XXW-X-X-XXW---XX
