WWWWWWWWWWWWWWWWWWWW
W------------------W
W--------------WW--W
W-----W------------W
W----------W--W----W
W-WW---------------W
W------------------W
W------------------W
W------------------W
W--------W---------W
W------------------W
W------------------W
W------------------W
W------------------W
WW----------------XW
W------------------W
WW-W---------------W
W-------W----------W
W------------------W
WWWWWWWWWWWWWWWWWWWW
