WWWWWWWWWWWWWWWWWWWW
W------------------W
W-----------------XW
W------------------W
W--------------W---W
W--------------W---W
W--------------W---W
W------------------W
WWW----------------W
W----------------X-W
-------------------W
W------------------W
W-------------W----W
W---W--------------W
W------------------W
W------------------W
W---W--------------W
W------------------W
W------------------W
WWWWWWWWWWWWWWWWWWWW
