WWWWWWWWWWWWWWWWWWWW
W------------------W
W------------------W
W------------------W
W------------------W
W------------------W
W------------------W
W------------------W
W------------------W
W-W----------------W
W------------W-----W
W------------------W
W------------------W
W------------------W
WW----------------WW
WW-----------------W
W------------------W
W------------------W
W------------------W
WWWWWWWWWWWWWWWWWWWW
