X-XW-X-----X--W-W-X-
X----X--XWX-WWWXXX-X
X----XWXWW---XWXWXX-
X----WXW-WWW-XX----X
W----X----W-W--W-WXW
W-XXXX---XX--XX-XWXW
XW---XXW---WXWXXWXXW
X---XW-W-XW-XX--WXXX
--WXXW---W-W--X-WWXW
-XX-X--XX-XWXWW-XW--
XXW--W-XW-XXW--X-WX-
--WX-W--X---W-XWXWX-
X-WWX---W-W-WXWW--XX
XW--WXXXXW---XW--XX-
WXXXWXWXXWXW-WWX-W-X
-XXWW-X--XWXW-WXWX-X
X-XW-W----XW-X-W--XX
XXWX--WWXWXWW-WW-X--
W-W---X--W-XX--X-XXX
------X---X-W---XXW-
