WWWWWWWWWWWWWWWWWWWW
W------------------W
W------------------W
W---------W--------W
W------------------W
WWW----------------W
W---------W-W---W--W
WW--------W-W---W--W
WW-----------------W
W------------------W
W---------------W--W
W------------------W
W------------------W
W--------W----W----W
WW------------W----W
WW-------W---------W
WWW--------------X-W
W------------------W
W------------------W
WWWWWWWWWWWWWWWWWWWW
