WWWWWWWWWWWWWWWWWWWW
W------------------W
W------------------W
W------------------W
W------------------W
W-----------------XW
WWW----------------W
W------------------W
W------------------W
W--------W--W------W
W--------W---------W
W-----------W------W
W------------------W
W-----------------XW
W------------------W
W----W------------XW
W------------------W
W------------------W
W---X--------------W
WWWWWWWW-WWWWWWWWWWW
