WW---WWWWW-------WWW
W-------------------
-------------------W
W------------------W
W-------------------
-------------------W
W------------------W
W--WW--------------W
W------------------W
-------------------W
-------------------W
--------------------
WW--------------W---
W-------------------
W-------------------
W-------------------
W------------------W
----------------W--W
W-------------------
W-----------WWWWWW-W
