----X----X---W--XXXX
-----WXWWX--XX---XW-
W----XX-W-WX-X--XXWW
X----X-X----XXWX--W-
-----------W--XXX---
WWXXX-X--W-XX-XXW-XX
X-X-WX-WWXXXXX-XW--X
WXWXW---W--XW-W-W-X-
WX-XX-X--XW--WWXWX--
XWW-XX-X-X-X-WXXWXX-
-WXWXW---WXX-X----WX
WWXX-WW-WXXX--W--X--
X-X---XW-XX--X-WW-XX
W-XWW---W----XXW-WXX
-W-WWXWXX-----XWX--W
W-XWW-WW--W-XXW--WWX
-X-X----X-X-X--W--WW
-WXXWX--XXWXWW--WX--
-X-XW-WXXWX--W-WXXX-
-XXXX-------W-X-XWXW
