-XWWX-XWXWWXW-XWW--W
-----WXWW---X--X----
X----XW----XW-W-X--W
X-----XWWWXXW-X---XW
X-----XW-WW--X-XW--X
X-X--X-W--W----W-WW-
-X---X--X--WWWXXW-XW
X-XW--XXWXW-XXW--XWX
XX-XXXWW-XXW--W--XXX
X-XWW---XX--XW-XWX-W
WX-XW-WXX--X-XWWX--X
-XWWX--W---XW---X---
X---W--W--XWXXWWWXXX
XX--XXXWWWXW--W-W-XX
XW--XW--X--WX-W-XX-W
-WWW---XW-W-WWXWXX-W
X-WX--X-W-XW-XWWWXXX
-XXWXX------WWXW-WWW
----X--XXX--W--X-W--
XXW--X--XX-X-WXXXXXW
