WWWWWWWWWWWWWWWWWWWW
W------------------W
W------------------W
W------------------W
W------------------W
W--------------W---W
WW-------------W--XW
W--------------W---W
W------------------W
W--------------W---W
W-W----------------W
W----------W-------W
W-W--W-------------W
W-W----------------W
W----W------------XW
W-W--------W-------W
WWW----------------W
WWW----------------W
W-----------------XW
WWWWWWWWWWWWWWWWWWWW
