WWWWWWWWWWWWWWWWWWWW
W------------------W
W------------------W
W-----------------XW
W-----------------WW
W------------------W
W------------------W
W------------------W
WW-----------------W
WW-----W-----------W
WW----------------WW
WW-----------------W
WWW-----------W----W
W------------------W
W-W----------------W
W-W----------------W
W--------W---------W
W------------------W
W------------------W
WWWWWWWWWWWWWWWWWWWW
