--W--WXX----W-WW-XWX
X----WW----WWXX-X-XW
W----WXWWXWWWXWXWX--
X----X-X--XX-W-XX---
X----X---XWXWWWWXXW-
X---W-XXW-XW-W-X--XX
XXXWXX-WXWWX--XW-WWX
-X-W-XX---X-XW--W--W
XW-XXW-XXX-X-W-W-XWX
-WWX-XX-XX--X-XW--X-
XWXW-WXX--X---XXXXW-
-X-W--X-X--XW-XW-XWW
WWX-X--X-XWXWXXX---X
X-X--XX-X--WWW-XX--X
W-WXX--X--W-XX---X-X
--WWXXX-XWW--XX-XXXX
-XXXX-X-WXX-X--WXWXX
XWWXX--XX-XX-XW---X-
XX-WX-X---X-XXX-X---
-X-X--W-W-XWXXW-X---
