WWWWWWWWWWWWWWWWWWWW
W------------------W
W------------------W
W---------W--------W
W---------W--------W
W------------------W
W-W---------------WW
W---------W--------W
WWW-------W--------W
W---------W-------WW
W-----------------WW
W-W----------------W
W-W----------------W
W-W----------------W
W------------------W
W------------------W
W------------------W
W------------------W
W------------------W
WWWWWWWWWWWWWWWWWWWW
