WWWWWWWWWWWWWWWWWWWW
W-----W------------W
W-----W------------W
W-----W----------X-W
W------------------W
W------------------W
W------------------W
W----------W-------W
W------------------W
W------------------W
W------------------W
W---W-------------WW
WW--WW------------WW
W-----------------WW
W-----------------WW
W-----------------WW
W------------------W
W------------------W
W------------------W
WWWWWWWWWWWWWWWWWWWW
