WWWWWWWWWWWWWWWWWWWW
W------------------W
W------------------W
W-----W------------W
W-----------------XW
WW-----------------W
WWW----------------W
W---------------X--W
WWW-W--------------W
W-----------------WW
W------------------W
W------------------W
W---W--------------W
W-----------------XW
W------------------W
W------------------W
WW-----------------W
WW-----------------W
WW------W----------W
WWWWWWWWWWWWWWWWWWWW
