WWWWWWWWWWWWWWWWWWWW
W------------------W
W-----------W------W
W-----WW----W-----WW
------------------WW
WX--W-W----------XWW
-------------W----WW
W-------W----W----WW
W-------W----------W
W-W-----W----------W
W-------W---------XW
WWW----------------W
W------------------W
W-----------------XW
WW-------------W---W
WW-------------W--XW
WW-----------------W
W-W----------------W
W------------------W
WWWWWWWWWWWWWWWWWWWW
