WWWWWWWWWWWWWWWWWWWW
W------------------W
W------------------W
W------------------W
W------------------W
WW--W--------------W
WW------WWW-W------W
WW----------W------W
WWW------W--W------W
W------W----W------W
W------W-----------W
W-----------------WW
W------------------W
WWW---------------WW
W------------------W
WWW------W-W---W---W
W-W----------------W
W------------------W
W--------------X---W
WWWWWWWWWWWWWWWWWWWW
