WWWWWWWWWWWWWWWWWWWW
W------------------W
W-----------W------W
W-----------W---W--W
W-----------W------W
W-----------WW--WW-W
W-----------WW-----W
W-----------W---WWWW
W---WW--W----------W
W------------------W
W-----------------WW
WW---W-----------XWW
WW---W---W-W------WW
W-----------------WW
W-------WW-WWWW----W
W-------WW-WW------W
W-------W---------WW
W------------------W
W---------W--------W
WWWWWWWWWWWWWWWWWWWW
