WWWWWWWWWWWWWWWWWWWW
W------------------W
W------------W-----W
W-----------W-----XW
W-----------------XW
W------------------W
W------------------W
W------------------W
W------------------W
W------------------W
W----------W-------W
WW--------------W--W
W-----------------XW
W-----------W------W
W-----------------XW
W-W----------------W
W-----------------WW
W------------------W
W-----------------WW
WWWWWWWWWWWWWWWWWWWW
