XWXX----W-WX-W----WX
----------WWXX-X--W-
-------X---X-XX-X-X-
-------X--XX--WXW-WW
-------X-W--X-W-X-X-
X-W--X---X-W--X--WWX
-X-X---XWXWX-X-----W
X--X-X--X-X-XX---WX-
XXX-X-W-X-XWW--WXX--
-X--W-W----XWW--XWWX
-X-X-----X-W-X---XW-
X-X---X-X-XX-WWW--W-
---WX-XWX-XX-W-X--X-
WXWW--X--W-X---X-XX-
-XW-X---X--XWWWXW-XX
WX-X-----WX-WX-XWX-X
X-XWX-X-XW--X-XXX--W
-W-X-----X-X--X-XWWX
XWX-XX-----W-WWW---X
-X-X--X-X-X--X-X---X
