W-XW-X---W-X--W-----
X------WW--WX--X----
X------W-XX---XWXW-X
X-----X-XWX--W---X--
------WXXW-XW-XXWXWX
--WX-WX--W--W-XX--WX
-X----X--XXXW--X-W-X
-W--W--X--XW-XX--X-X
XW-W-X-W--XW-WXW-W-X
XW-WWW-XX-XWX-WWX-XW
W-XX-W-X---WW-WXWXXX
XWXX-W-----XWX---XX-
-W-W--WWWXWW-XWWW-W-
X--WW-XX-XW--WW-X---
XX-WW-XW------WX-X-X
XXX-WX-WX--XX-XX---X
X-X--X--W--X---X-XXX
---X-XX--XXW---X-X-W
----XX-XWX--WW-X-X-X
--X--W----X---X-X--X
