--XWX-------X-X--W--
X-----X-X--X-X---XXX
X----W-XW--XX-XW-W-X
-----XXW-W-XW---X---
X----WXX-WXXW--XXXX-
XXXXXX---W-XXW-XW-XW
X-XXXXXW-XX--WXW--WX
-W--WW-WX-X---XW-WX-
-----W-WXWX----W-XXX
-XW---X-W---XXX-X--W
--XX-W-XWWX---X---XX
X-WW-WWXWXWXX-XWXXXX
-XWW-WXWXXXWWXWX-W--
WX-XW--XW-XXXW-----W
WW--XX-WXWW-XX-WXWWX
-W-W--X---X-W--WW-X-
-WWWX--XWXX-XX-WXXWW
W-XW-XXXX-W-XX-W--XW
-W-X-X-W-XW-WXWWW--X
XWXWXX-X--X-----X---
