WWWWWWWWWWWWWWWWWWWW
W------------------W
W------------------W
W------------------W
W---------WW------XW
W-W-------W--------W
W---------WW-------W
W--------------W---W
W--------------W---W
W------------------W
W-----------------XW
WWW----------------W
W------------------W
W------------------W
W------------------W
W--------------W---W
WW-----------------W
W---W--------------W
WW-----------------W
WWWWWWWWWWWWWWWWWWWW
