XW-W----X-XWX--W--X-
------X-X----W-W-W-X
X-----W-X---W-WWXXWX
------X-XXW-XWWX---X
X-----WWWWWXWWW-XXWX
XX-X------W--W-X-XXW
XWXWW-XW---XWX-X-X--
-W-X-X-X-XXXW---W--W
---W-WW-XXXXX--XWX-X
X-XW-W-XXX-XXX-WXWXX
-X----WWW--XW-X-WXXX
-XX-WX-WWWXXWX-XWXXX
XWWXW------WX-XWWWXW
---X--XWWXW--X--XX-X
-X-XWWXW------XWXXX-
-XX--X---XX-XWW-WWXW
-X--XX--WXWXXW-XX-XW
X-WX-X-XW-W--W--X-X-
XX-W-WW-X-----XXWXXW
W--------X--W-WWX---
