W-X-X-XWW-XWXW--WW--
X----W--XW-X-XW-XXXX
W--------XWW-XXX---X
-------WW-XWW-XX---X
X----XWXXWXWXWX--W--
-X--X-WXXW--XXX--XWX
WWXXWX--X-X-XX--XWXX
WXXXXWXWXXWX--W-W--X
--XX-XWW-X---X---XWX
X-WX-----X-XX--XXW-X
X--XX---WWX-----XW-X
--X-W-XX--XX--X-XW--
---W-X--WWWXXXWXWWWW
--WX--XW--X---XW---X
--X-XW--WXWX-XXX--XX
XXXX-XX--XXWXXXWX-XW
WX-X--W-WXW--XW---X-
XW-XXXX-XW-X-XW----X
XX-WXXX-XXWW-X--XX--
W-X-W--X--X--X---X--
