WXXX-WWW--W--X-X--X-
X------W--X-XX--X---
------XX---------XW-
W----W-XXWWWXX--WWXX
-----XW--X-XXW-----W
----W-X---X-XW-X-WX-
X-WXW-WWX-XX-X--WWW-
---X-XXX---XW-XX--W-
--WXWWXWX---XX-WWW--
XWXX-X-W---WWXWW--W-
XXXXXX-X----X----X-X
XWXXW-XW-WX-WX-WW-XX
-XW---WWWWX-WW-X----
X-X--W-WXX-X---WX-XW
W-W--XWX----XW-X-XXX
-W-W-W-W-XWX-X-XW-XX
---XX---XWX-XW---W-X
XWX-X-X---WX-WXWW--W
-X----X--XWW--X--WW-
X--X-XXW-----XXX--WW
