--X-XX---X-X---X-X-X
----------XW--X-XX-X
-----XXXXWX-X-XW-X-X
-----WWWXXX-W-XXW---
-------WWXX-----WX--
---XX--X-----XXW-W-X
W-WXXX-WXW-WXWXX-WXX
XX-XXX-WXW--X-W-XW--
-X-X---WW-WXWXX-WX-X
-WX-XWW-X-WX-W-XWW-X
XW-WWXWX---W-W---W-X
----WW-WWX-XW-WW-XXX
---X-X-WX---XW-XXW-X
XWWX----WXW-X-XWWX-X
XX-XW----WW--XW--WW-
-XWWWX-XXW-XX-WW-WXW
WX-W-XX-X-W-----X--W
-XWWXWXXWX-X---X-WWX
-WWW-WW---XW-W---W-X
--X--XW-WXWX-----X-X
