WWWWWWWWWWWWWWWWWWWW
W----------W---W---W
W------------------W
W-----------------WW
W-----------------WW
W------------------W
W------------------W
W------------------W
W----------WW------W
W-----------W-----XW
W-----------------XW
W------------------W
W------------------W
W------------------W
W------------------W
W------------------W
W-W-------------X--W
W------------------W
W-----------------WW
WWWWWWWWWWWWWWWWWWWW
