---W-----W--XX-WWXWX
X-----W-XW-WWWXX-X-X
W------W-W-----XX---
W----X-XXWW--WWWX-WX
-----XX--W--W--WWX-X
WW-WWWX-XWX-X-WWWX--
--XWXWX-WXWXWW--WW--
XWX---WW--X-X--X-W-X
WXXW-X-WW---X-WX-XX-
X--XW-W-WX-WXWXXW-X-
-XX--W--WXWX-WX---X-
XWXX-W-XWX--XXWWX-XX
---W-X--WXXXW-WWW-XX
-XWXXXXW-WXXW---W---
WWXWW-WX-XWXX---XXXW
XW--XW--X---W----XWX
-X----X-X---XW-X-X--
XWX-XX-XWWWX-WXXX--W
XXWX-X----W---X-XWXX
X-XXX-XX--XWX--X--XW
