--W-XW--WX-XX-------
X--------WXWWX--XX--
X----WX--XX-WX-WX-X-
X----XXX--W-W---WXWX
X----WWXW--X-XXXX-WW
XW-X----WX-WXW--W--X
XW--XW-XWWWX-WXXXX--
-WX--W----X---W-XXX-
XWWW--X-XXXXW-XW-WX-
-X-XW-XX-X-XWX-XX--W
W-WXX--X--X---XWW-X-
--W--XW-X--WWW-XWWXW
-XWWWXXWWW-XX--X-XX-
X--X-X-XW-XW-X-WW--X
XXXX--W--W---W-XXX--
X-XXX--X-WXWXXX-WX--
W-WW-X-X--WXWW-XX-X-
--WWXXXXW--WWXWW--W-
----XWX-----WX-W-XW-
XW--X----X---XX---WX
