-XXX---XWXW-XWXW-XXX
X-----XWX--XW-X-WX-X
W-----XX----X----XWW
X----W-XXX-W-XX-WW-W
X----X-W-WWXWWXWXXX-
W--WWXX--W-XXW--W---
X-W-XWX-XWX------WXW
X-XWX-W-X-X-WW-XWWXW
--XX--WXXWWXXW-WWWWX
-X-X-W-WWXX-XWX-X-W-
XWX-XWXW-WXWXXX-W-W-
XWXX-X-XW-WWWWWXWWWX
X-XX-X--W-WWWWX---XW
X--W-XW-WXWWW-X---X-
-W-WXWWX-XXW--W-W-XW
--XWXX--XW-WW--WWXWX
W-W--XW--X--W---XWXW
-X-W--W------XW-X--W
WX-WX--XXW-X-XX--WXX
XX--W--WXX-W--X-X-X-
