WWWWWWWWWWWWWWWWWWWWWWWWWWWWWWWWWWWWWWWW
W---X-----------------------X--XW------W
W-----------W---------W--W-W-----W-----W
W-------W--------------------W---------W
W------------X-------------W-----X----WW
W----X--------------------------W------W
W----W-------W-W-------------W---------W
W------X------X------------------------W
W---------X-----W----------------------W
W----------W-WXW-------W---------------W
W---------XW-------------------------X-W
W---------W----------------------------W
W--------------------------X-------X---W
W------------W-----W------------W-X----W
W-------------------------X------------W
W-XX---X--W--------------------------X-W
WX-------------------------------X-----W
WW--------X------X----------X----------W
W--W---------------X-------------------W
W--W-----------------------X-W---------W
W-----------W-------------------W---W--W
W---------W-----------X----------------W
W----------------------------X---------W
W---------------WW-----WW-----W--------W
W-------------W--------W---------------W
W---------X--------X--W-W--WW---------WW
W----------X---------------------------W
W-----------------------------WW-------W
W--------------------------------------W
WW------------------------W------------W
W--W-----------------------------------W
W--------------------------------------W
W-X--W-------------X--------------X----W
W--------------------------------------W
W-X--X---------------------------------W
W------W---------W------X-------X--X---W
W----------------W-----------------W---W
W--------------X------W------X---------W
W---------------------------W----------W
WWWWWWWWWWWWWWWWWWWWWWWWWWWWWWWWWWWWWWWW
