WWWWWWWWWWWWWWWWWWWWWWWWWWWWWWWWWWWWWWWW
W------------------------------X-------W
W--------------------------------------W
W----W--X----------X-------------------W
W----------W-------W----------W--------W
W----------------------XW--------------W
W--------------------------------------W
W--WW-X--------------------------------W
W-----------WX----------W--------------W
W-------W-----W--------------------X---W
W--------------------------W--------X--W
W-----------------W--W-X------------W--W
W---------------------W----WW----------W
W--------W----------------W---X--------W
W-------------X------------W----------WW
W--------------------------------------W
W----------X----------------X---------WW
W---W--------------------------W-W-----W
W------------W-----------------------W-W
W----------------------------W---------W
W-----X-------------------X--W---------W
W-X---------------W--------------------W
WW------X---X---X----------------------W
W------W--------X----------------------W
W-W---------------W---------W----------W
W-----------X---X----W----------W--W---W
W--------------------------------------W
W--------------------------------------W
W--------------------------------------W
W--------------------------------------W
W-----X----------------------W---------W
W----------W---------------W-----------W
W-W------------------------------------W
W--------------XX--X-X-W---------------W
W-----X-------W------------WW------W---W
W------W----------------X------------X-W
W------------W-------------------------W
W--------------------X-----------W-----W
W----------------------------------W---W
WWWWWWWWWWWWWWWWWWWWWWWWWWWWWWWWWWWWWWWW
