WWWWWWWWWWWWWWWWWWWWWWWWWWWWWW
W---W----W---W------W-W---X--W
W---X--W------W------W--WWWWWW
W-W------WW-W------W----WW-W-W
WWW-W------X-W----W--W-----W-W
W---WW-----W-----W-WWXW-W-W--W
W---W---W-WW--W--W--W-W-----WW
W--W--X---W------W-W---W---W-W
W--W-----W-W--W-W---W--W-----W
WWW------X---W---WWW---W--W-WW
W---W---W----W------W----WW-WW
W----W-W-XWXW----W---W-WWW-W-W
WWW----W---X--WWWWW-W--------W
W--WWW--W---W-W---X-W--------W
W--X---W-W----W----------W--WW
W-WWWWWWW-W-XWW---XW--W-W----W
W------W---------W-----W-----W
W-W------W--WW-W--W---W--W--WW
W------W-WWW-W---W----W--WX-WW
WX-W--W--X----------W----W---W
W---XW------W---W--W--X------W
WW---X---WW--W---------WWW---W
W--W---WX-----WW--W--W------WW
W--X-W-W-------W--W--W-WW--X-W
W-WWW---X----W---------W-W---W
WW-W--W--WWW----WW-W-W---W---W
W---W-W-W--W----W-------WWWW-W
W--W--W---W---WW--------W----W
WX---WX----W--WW-------W----WW
WWWWWWWWWWWWWWWWWWWWWWWWWWWWWW
