WWWWWWWWWWWWWWWWWWWWWWWWWWWWWWWWWWWWWWWW
W-W----WW----W--W---XW--WW---X--W------W
W-----X----------X---W---X-----W--X----W
W--X---W--W-WW----------W-------W-W----W
W--W-----WWX-W---------------W------WWXW
W------W---W-W-W---W------------W------W
WXW-----X-W---W---------------WW-W-----W
W---W-------W---WX------W--W---W-W-----W
WW-------------------W------W---WW--W-WW
W---WW----------WW-------WXX-----W-----W
W--------X-W-W-X--W----W-----W--W----W-W
W--W-------------W---------------------W
W-------W--------------------WW--------W
WX----------W----X---XW-------W--------W
W-------X--W-----W--------W-----XW--WX-W
W--W-----------W-W------W-----W-W------W
W--W----X------W------W---W--W---W-----W
W-X--X-----W-W--W---------W-------W-W--W
WW-------------X----W------X-----------W
W--W------------W--W-----W------W-----XW
W-W--------W----W--W-W---X--X--W----W--W
W------------------W-----W-------------W
W--------W-W--------W---------W--------W
W---W-X---------X-----W-----W-W-W-----WW
W----WW-------WW-WW-W------W-W---------W
W---WWW-W----XW-W-------------W------W-W
W-----------W-WW--WW---W---X-----------W
W--------W-----------------W---W------WW
W--W------W-------W------W--W-----W----W
W-----X---W----X--W--------W----------WW
W-------------W--W---------------------W
W--------------X----W------------------W
W----X-------W--X------W-----X-------W-W
W--W--------------------------W-W--W---W
W---------WWW-----------------W--------W
W------W-W--WW-----------W--W----------W
W-------X----X-W------W----W------W---WW
W------------W---XWW------W----W-----W-W
W--X---W---W----------WW-----X-----W---W
WWWWWWWWWWWWWWWWWWWWWWWWWWWWWWWWWWWWWWWW
