WWWWWWWWWWWWWWWWWWWWWWWWWWWWWWWWWWWWWWWW
W---W------X------W------------X--W-WW-W
W--------WW-W------X-XW---W-------W-W--W
W-----W----W-----------------W----W--W-W
WW----W-------W--------W-W--WW--W--W---W
W-----------------------W--W-W---------W
W---WW-XW-----------------W------------W
W----W-------W-------------XW----W-W---W
W---W----------------XWW-----W-W-------W
W---W-------XXW------------------W-----W
W---W-----W--------WW--X--------W------W
WW----W--WW---W-W-W---XW-------W--X-X--W
WW-----X---W---X---W-W-------------W-X-W
W--------WW-W------W---------W---------W
W-W----------W---W--W--W---------------W
WWW----W---W-------W-WX---W---------WW-W
W-----X-W--WW----WW-------------W-----WW
W---------W--W---W----W-------W--------W
W-------W-----W------W--------WW-----W-W
W-------W--W-XW---XW--W----W--W--------W
W-----W------W---WW----W-------X----W-XW
W----------W----------WWW----W-W------WW
W--------WW--------------------WX------W
WW-----W-----W--W----X---------W------XW
WWW-W---W--W--------------------------WW
W---------XWW----W----W-W-------W-W----W
WW---W-------------------------W----X--W
W-X--------W--W--------W-----XW--------W
W-W------W-W---------WW-----W----------W
W-------WW--WW---W--W-W--------WW--W---W
WX--------------X--W------X-W-------W--W
W------------W------X---W-W--------W---W
W------------------W-------W-------W---W
W---X---------W---X---------W----W-----W
W-----------------------------------W--W
W--------W--W-W-W---W----------W-------W
W--W--W--------WW--W------------W------W
W----------------------W--W----X----WW-W
W--------WW--X--W-----------WX---W-----W
WWWWWWWWWWWWWWWWWWWWWWWWWWWWWWWWWWWWWWWW
