-------------W------
WW--WW---W--W----W--
W-----W-------------
--------W-W--W--W---
W----W-W---W----W---
--W-W--W-W--W----W--
----W--W---W--W-W-W-
-----------W------WW
---W-------W--------
-----W---W----WW---W
W-W-----WW-W-----WW-
---W-W-WWW---------W
-W-------W-W--------
-W--W---------------
WW---W-W------------
WW--------WW--------
--------------------
WWWW----------------
--W-W-W-------------
--W----------------X
