WWWWWWWWWWWWWWWWWWWWWWWWWWWWWW
W----W-W--WW---W--------W----W
W-W------W---------------WX--W
W--------X--W------X---------W
WW------W-------W--W-------W-W
WWWWW--WWW---W------W-WW-----W
W-X----X--W-WW-W------W--W---W
W-WW------W-------W-W-W------W
WW---X---W--W------W-------W-W
W---W---W-------W-----W----X-W
W------------W-W-----WW---WW-W
W--X---W--W-----------W---W--W
W-----W--W-------W--W--------W
W-------W----WWW----X------XWW
W---X-------W-------W------W-W
WWW--X---W--WW-WW----W------XW
W-W-----------WW--X----------W
W-----------------WW----W--W-W
W---W----------X-------------W
W---------W---W------W-------W
WWW-W--------W--------X-----WW
W--X-------W----WW--W--W-----W
W-----------W---W--W--XW--W--W
W--WW---X--W---W----W-W----W-W
W-W-X-WW-----WW---W----W-----W
W-W--WW---W-----W--------WW-WW
W------XX----------WW-WW-X--WW
W--WW-W---W-W----------------W
W----------W--WW---WW-----W--W
WWWWWWWWWWWWWWWWWWWWWWWWWWWWWW
