WWWWWWWWWW
W-W------W
W--------W
W---W---WW
W-W-W----W
WX-------W
W--WW-W--W
W---X--XWW
WX---XX--W
WWWWWWWWWW
