WWWWWWWWWW
W--------W
W--X-----W
W-------WW
W---XW---W
W--------W
W------W-W
W---W----W
W--------W
WWWWWWWWWW
