WWWWWWWWWWWWWWWWWWWWWWWWWWWWWW
W----------------X----------XW
W----------------------------W
W----------------------X-----W
W----------------------------W
W-----------------X---------XW
W----------------------------W
W----------------------------W
W----------------------------W
W----------------------------W
W----------------------------W
W----------------------------W
W----------------------------W
W----------------------------W
W----------------------------W
W----------------------------W
W----------------------------W
W----------------------------W
W----------------------------W
W----------------------------W
W----------------------------W
W----------------------------W
WX-------X-------------------W
W----------------------------W
W----------------------------W
W----X-----------------------W
W----------------------------W
W----------------------------W
WX-------X-------------------W
WWWWWWWWWWWWWWWWWWWWWWWWWWWWWW
