WWW-WW-W---W-WW-W---
-----W--WW---W-WW-WW
W----W-----WWW------
----------WWW-W--WWW
W----W-WW---W--W---W
WW-W------W---------
--W-W-W--W--W-WWWW--
W----W-W----------W-
W---W----W-W----W--W
W-----W-WWW------WW-
-W---W-WWW-W--------
WWWWW-W--W--W--WWWWW
-----WW-WW-W-W-WW---
-W-W----W--W-WW-W-WW
WW---W--W---WW------
W--W--W---W-----W--W
-----W-W---WWW-WWWWW
WW-WW--W-WWWW-WW----
XWWW-W-W--WW-W-----W
W-W-WWWW---------W-W
