-W------WW-----WWW--
-------W--W-WWW--W--
------WW--WWW-WWW-WW
W----W--WW-------W--
W----W-WW--------W--
-WWW--WWW-----WWW-W-
WWWWWWW--W--W-------
WWWW-WW----W-WW--W-W
XW---WWW-W------W-W-
XW-WW-WW--W-WWW-----
-W-W-W--WW-W-W--W--W
WW----WW----W-W-----
W---WW-W--WWWW-WW--W
--WWW-WW-W---W---WW-
W-W-------W-W---W--W
W-W--W---W--WWW-W-W-
---WWWW-W------W-WW-
WW--------W--WWW--W-
--W-WWWW----WW------
W--W--WW--WWW-WWW-WW
