--W--WW----W----W--W
W----WW-WW-WW--W-WW-
-------W-----W-WW-WW
W----W-W-W-WW---WWW-
W------WWW-W--W-WW--
WWWW-WWWW-W--W--WWWW
-W--WW---WW----WW--W
W-WW-W-WWW-WW-WW--W-
W------W---------WWW
-WWW----WWW-WW-WW---
W-W---WW---WWW--WWWW
WWWWW---W-WWW--WW---
W--WW------WW---W-W-
W-W--WW---W---W--W--
---WW----W-WWWWWW---
------W---W-------W-
WW-------WW---WW-W--
---WW--W-W--W---WW-W
-W----W-WW-W---W--WW
W--W-WW-W--W--W-WWWX
