WWWWWWWWWWWWWWWWWWWW
W------------X---W-W
W-----------W------W
W---------W--W--WW-W
W-----W--W-------X-W
W--W--------W------W
W------W--W--------W
W--WWW------W---WW-W
W------------------W
W----W----WW-------W
W--W----W-W---W---XW
W-W-----W-----W----W
W-------W--W-WWW---W
WW-----W---W----X--W
W-W-W-------W-----WW
W------------WW----W
W--W----W-W--W--W--W
W--WW------WWWWW---W
W------W-----------W
WWWWWWWWWWWWWWWWWWWW
