WWWWWWWWWWWWWWWWWWWW
W------WWWW------WWW
W------WWWW--------W
W------WWWWWW------W
W------WWWWWWX-----W
W------WWWW---X----W
W------WWWW-------XW
W--WWWWWWWW--------W
W-WWWWWWWWW---WWWW-W
W-WWWWWWWW----WWWW-W
W--WWWWWWW---W-----W
W-WWWWWWWW---W-----W
W-WWWWWWWWW--W-----W
W-WWWWWWWWW--W-----W
WWWWWWWWWWW--W-----W
WWWWWWWWW----WX----W
WWWWWWWWWWW--------W
WWWWWWWWWWW--------W
WWWWW--XWWW--------W
WWWWWWWWWWWWWWWWWWWW
