WWWWWWWWWWWWWWWWWWWW
W----W--------W----W
W---W-W--------W---W
W---------W----W---W
W-----W---W-WW-----W
W---W--W-----------W
W----W-W-----------W
W----------X-------W
W-------------W----W
W----------W-------W
WW---XW------------W
W--------------W---W
W------------------W
W------------------W
W---W-------W------W
W---X------W-W-----W
WWW-----------WX--WW
W--------W------WW-W
W----WW----W-------W
WWWWWWWWWWWWWWWWWWWW
