WWWWWWWWWWWWWWWWWWWW
W------------------W
W--------WWWWWWW---W
W---WW---WWWWWWW-X-W
W---WW-WWWWWWWWW-X-W
WWWWWW-WWWWWWWWW-X-W
WWWW---WWWW--------W
WWWW---WWWW---WWWWWW
WWWW----------WWWWWW
W-----------WWWWWWWW
W---WW-WWW--WWWWWWWW
W---WW-WWW--WWWWWWWW
W---WW-WWWX-WWWWWW-W
W---XWWWWWWWWWWWWW-W
W----WWWWWWWWWW-WW-W
WWWW-WWWWWWWWWW-WW-W
WWWW-WWWWWWWWWW-WW-W
WWWW-WWWWWWWWWW-WW-W
WWWW-WWWWWWWWWWXWW-W
WWWWWWWWWWWWWWWWWWWW
