WWWWWWWWWWWWWWWWWWWW
W------W-----W-----W
W---WW--W----------W
W-----W-X-W--WW----W
W---W----------W---W
W-----W------------W
WWW----W---------W-W
WW----------WW----WW
W------W------WWWW-W
W----W------W-W--W-W
WX-----------W-W---W
WW-----W----W------W
W-----------W------W
W----W-----W-W---WWW
WW-------W------W--W
WW------WW-----W---W
W------WX-W--W-W---W
WX-W---W-----------W
WW-----X-----W----WW
WWWWWWWWWWWWWWWWWWWW
