WWWWWWWWWWWWWWWWWWWW
W----W-----W--W-W--W
W-------W------W-W-W
W-------W----W--WW-W
W------------------W
WW-W--W---W-W-X-W-WW
WW----------W-W----W
W---X---WW----X----W
WW--W----W---W-WW--W
W------W----W------W
W--W-W----W-W---W--W
WW-W------WW-----W-W
WW--W-------W-W----W
WW------W-W--------W
WW------W-W---W----W
W--W-----W-----W---W
WW-W----X-W-W-W-W--W
W--------------WW--W
WX-W----WWW-W-W----W
WWWWWWWWWWWWWWWWWWWW
