WWWWWWWWWWWWWWWWWWWW
W---------------W--W
W-------W---W------W
W------W---X-------W
W----W--W---W--WW--W
W--W-W--W----------W
W----W-W-W-WW-----WW
WX---------------W-W
W-----------------WW
W-W--W-------------W
W-W-----------W----W
WW-----W-W--WW-----W
W----------WW-----WW
W--W--------------WW
WW-------W--WW----WW
W--W---------------W
W------WW-----W----W
WW-----------------W
W-------W---W----W-W
WWWWWWWWWWWWWWWWWWWW
