WWWWWWWWWWWWWWWWWWWW
W-------------W--WWW
W--------W---WW----W
W--------X-----W-W-W
W-WW--WW---------W-W
W---------W--W-----W
W-------W------W--WW
W---W-----W-----W-WW
W------------W-----W
W--------W----W----W
WW-XW-------W--W---W
W----W----W-WWW-WW-W
WW-------W----W---WW
W-X--W-W---W-------W
W----W-------------W
WWX-W---W----------W
WW----WXW----W----WW
W-----WW-------W-W-W
W----------W-------W
WWWWWWWWWWWWWWWWWWWW
