WWWWWWWWWWWWWWWWWWWW
W----W-W-----------W
W------WW-----W----W
W----X-W-----W--W--W
W--W--W--X--W----W-W
W-WW----W----W-W---W
W-----W-W--------W-W
W--W---------W-----W
WW--W----W---------W
W--W--W----W-------W
WX------------X----W
W------W-WW--------W
W---------W-W------W
W---------W-W-----WW
WW------------W---WW
W------------------W
WWW--X-----------W-W
W--------W-----W---W
W-W------W--WWX----W
WWWWWWWWWWWWWWWWWWWW
