WWWWWWWWWWWWWWWWWWWW
W------W-----------W
W------W------W----W
W---W--------W---W-W
WW--------W-W-W----W
W-W--------------W-W
WW--W--W---------WWW
W-----------W------W
W--W-WW---W-------WW
W--W--W------X---W-W
W----------WW---W--W
WW-X----------W----W
WW--------W-W-WW-W-W
W--------------W---W
W-------W---------XW
WW-------W---------W
W---W-W------WW----W
WX------WW--W---W-WW
W------W--W-W------W
WWWWWWWWWWWWWWWWWWWW
