WWWWWWWWWWWWWWWWWWWW
W-----------------WW
W---WW----W-----W--W
W---W-W---------W--W
W--W---------------W
W--------W-W-W----WW
W----W---------X-WWW
W-W--W--W----W-----W
W--W---WW--------W-W
W-----W-X----W-WW--W
W--W---------------W
W------W----W--W---W
W----------W---W---W
W---------------W--W
WX----W--W--W------W
WW-W---------------W
W------------------W
WW---W-------------W
WW-X---------------W
WWWWWWWWWWWWWWWWWWWW
