WWWWWWWWWWWWWWWWWWWW
W-----------WWW-W--W
W---W------W-------W
W------W--WW--WX---W
WWW----W----------WW
W--W------W----W--WW
WW-------------W---W
WWW-W--WW----------W
W----W--XX-----W---W
W------------------W
W-----------W------W
W---------W-WW-----W
W-------W----------W
W----W--W--W---W--WW
W---------WW---W---W
W----------W-------W
W--W--W-------W---WW
W--W-W----W--------W
WWWW---------------W
WWWWWWWWWWWWWWWWWWWW
