WWWWWWWWWWWWWWWWWWWW
W---W----W---------W
W---WWW--W-W-X----WW
W-----W----WWW-----W
W-----X---WW-------W
W------W------WWW--W
WW--W--WW-----W-W--W
W-W---W-WW--W------W
W-W------W-W---W-X-W
W---W--W-W-----WWW-W
WW--------------W--W
W---W-WW-W---X-W-W-W
W------WW--WWX--W-WW
W----W---W---XW-W--W
W-W---W------------W
W---W-W-W---W------W
W--------W---------W
W--W-WW--W----W--W-W
W----------W----W--W
WWWWWWWWWWWWWWWWWWWW
