WWWWWWWWWWWWWWWWWWWW
W-------WW----W----W
W-----W-----W--W--WW
W------W-W-W-W--W-XW
W--WW--W----W-W----W
WWW--W--WW---------W
W-----WW-W-------W-W
WWWWW--W--WWW-WW-WXW
W-W---XX-W---------W
W---W--W-----------W
W----WW--WW--------W
W-------WW--W----WWW
W-W--------W--W----W
W----------------W-W
W--X---W--W---WWX--W
W----W-------W-WW--W
W---WWW--WXW-W-----W
W-W-W------W-------W
W-W----------W-----W
WWWWWWWWWWWWWWWWWWWW
