WWWWWWWWWWWWWWWWWWWW
W---------W-----WW-W
W------------------W
W----W-----------X-W
W---W-------WW--W--W
W------------------W
W--W----WW----X----W
WW--W--------------W
W-------W-----W----W
W------------------W
W-------X------W--WW
W---------X-----WW-W
W-----W---W--------W
W----------------X-W
W---------W-----W-WW
W----------WW-W----W
W---W--------------W
W-------W----------W
W---------------W--W
WWWWWWWWWWWWWWWWWWWW
