WWWWWWWWWWWWWWWWWWWW
W-----------WX-----W
W-----XW------W----W
W-----W-W---------WW
W--WW---W---------WW
WW-W-W-X--WW----WW-W
W-W------W---------W
W----W---W--WW-----W
W-W-------X--W-----W
W-----------W--W---W
WW---W--W----------W
W---WW--W--WW------W
W---WWWW--------W--W
W-W----WW---W---WWXW
WW-----W--WW-------W
W--W--W----W-----W-W
W----W-WW-WW-------W
W----W--WX-WW--W---W
W----W---W--W------W
WWWWWWWWWWWWWWWWWWWW
