WWWWWWWWWWWWWWWWWWWW
W------------------W
W------W--W--X---W-W
W---------W---W---WW
W-------X-----WW---W
W--W-W---W-----W--WW
WW------W-WX-W-----W
W--------WW--W-----W
W--------------W---W
W-W--W----W--------W
W----------------W-W
W---W-----------X--W
W-W--------W---XW--W
W---WX------------WW
W---W----W----W----W
W------W-----------W
WW--------------XWWW
W----W----------W--W
W---------W-------WW
WWWWWWWWWWWWWWWWWWWW
