WWWWWWWWWWWWWWWWWWWW
W-------------WW---W
W-----------W------W
W------W-----------W
W----W----------W-WW
W------------------W
W--W---W-W----W----W
W---W-----------W-WW
W---W---W--------W-W
W-----WWWW---W-----W
W-W-----W----------W
W-W----WW---W------W
W-----------W---W--W
W-----W----------W-W
W----------W-X-----W
W----W----WW--W-XWXW
W-------------W----W
WW-W--------W----W-W
W---------W-W-----WW
WWWWWWWWWWWWWWWWWWWW
