WWWWWWWWWWWWWWWWWWWW
W------------X-----W
W----------------W-W
W----W----W---W----W
W--W---------W--W-WW
WWW-----WW----X--WWW
W-WW-----------WW--W
W-----------W--W---W
W-W----------W-----W
WW-----W--------WW-W
W-----W-------W---WW
W-------X---W------W
W-----------WWWW--WW
W---------X--------W
W---W-WW-W-X-----WWW
W------W--W--------W
WW-W------W---WX---W
W-W--------W--WW---W
W---W-----W-W----X-W
WWWWWWWWWWWWWWWWWWWW
