WWWWWWWWWWWWWWWWWWWW
W------------------W
W---W------W---W---W
W----W-------W-WW--W
W-W-----WW--W------W
W---W--W-W---------W
W--W-W--------W-WW-W
WW--WX-WW-W-----W-WW
W---X----W---------W
W----W---W--W---W--W
W--------X--W-W--WWW
W--------W---------W
W-----W-----WW-----W
W----------W---W---W
WW--W--------------W
W-W----------------W
WW-----WW-WX-------W
W-W---WW---W-------W
WWWW---------------W
WWWWWWWWWWWWWWWWWWWW
