WWWWWWWWWW
W-W-XX---W
W--W---X-W
W--W-W---W
W--W----WW
WW-W---WWW
W-WW--W--W
W----WWW-W
W--WW----W
WWWWWWWWWW
