WWWWWWWWWW
W----XX-XW
W-W-W---WW
W-X-WX---W
W---W-W-WW
WW--WW-WWW
WXWX-----W
WWX------W
WWXWW-WW-W
WWWWWWWWWW
