WWWWWWWWWW
W--------W
W--W--WW-W
W-X----WXW
WWW------W
W-WX-X---W
WW--W-W--W
W--------W
W--WWX-X-W
WWWWWWWWWW
