----------------W-W-
--------------------
W-W------W---W----WW
W-------W-----W-----
--------W----------W
--W----W---W---W----
----------------WW--
--W-----------------
W----W-------------W
---W-W----W-----W-W-
------W-WWWW---W---W
W--W----W-------W--W
------W----W--------
------WW-------W-WWW
--WWW-----WW-------W
----W----WW-W----W--
--W------------W----
-------W----WWWW----
------------WW------
---W-----W---------X
