--W-------W------WW-
----W-W-W-W---------
--W-----------W-----
-W------W--W----W--W
--------------WWW---
--------------------
--------------------
--------------------
--------------------
--------------------
--------------------
--------------------
--------------------
--------------------
--------------------
--------------------
------------------X-
----------------XX--
----------------X-X-
--------------------
