WWWWWWWWWWWWWWWWWWWWWWWWWWWWWW
W----------------X-----------W
W--------X-------------------W
W-----------X----------------W
W----------------------------W
W---------X-----------X------W
W----------------------------W
W----W------WW--W------------W
W------X--------X------------W
W----------------------------W
W-----W-----X----------------W
W------------X------W----X--XW
W---X--X---------------------W
WW-------------W---X---------W
W----W-----------------------W
W------------X-------W-------W
W--------W--------------X----W
W--------------------------X-W
W----W-----------------------W
W----W--------X--------------W
W----------------------------W
W---------------W------------W
W----------------------------W
W---------------X------------W
W----------------------------W
W---------------------------XW
W-----X----------W-----------W
WW------------W--X----X------W
W----------------------------W
WWWWWWWWWWWWWWWWWWWWWWWWWWWWWW
