WWWWWWWWWWWWWWWWWWWW
W--------------W---W
W------WW----------W
W--------W--------WW
W--------W----W----W
W--W---------------W
W------------------W
W--------------WW--W
W---------W-----X--W
WX-------------WX--W
W-----W-W----------W
W-----W----X--WWW--W
W----------W-------W
W-W--------------W-W
W----WW-------W----W
W---------------W--W
W-W-------------W--W
W--W--W-W-------W-WW
W----W-------------W
WWWWWWWWWWWWWWWWWWWW
