WWWWWWWWWWWWWWWWWWWW
W----WW--W-W----WX-W
W----WW-----WW--W--W
W----X---X-W-------W
W---W--W---W------WW
WWW----W-W-W-----W-W
W----X-W--X------W-W
W----W-------------W
WW----X------WW---XW
WW--------W-W------W
W----------WW-WW---W
W--W-------WW---W--W
W---W---W-----W---WW
WX----W------------W
W---W-WW---WWWX-W--W
W----W-W--WXWW-X-WWW
WW----------WW-X---W
W----------W-----W-W
W-----X-XW-------W-W
WWWWWWWWWWWWWWWWWWWW
