WWWWWWWWWWWWWWWWWWWW
W-------W--------W-W
W----X--W----WWW--WW
W---W--W--W-----WX-W
W-----------WW-X---W
WW---W----------W--W
W------W-----------W
W--------W---------W
W-----XW--------W--W
W-W-W---X-----W----W
W----------W-W--WW-W
W-------W----------W
W-----W------W---W-W
W--W----W----------W
W-W-W---W---------WW
W-W-W-----W-W------W
WW---W----WW-------W
W--------------WXWXW
WW--W----WWX-------W
WWWWWWWWWWWWWWWWWWWW
