WWWWWWWWWWWWWWWWWWWW
W--------W-W-W-WWW-W
W-----WW-W----X--WWW
W----W----------W-WW
W---W---W--W---W-W-W
W-W-----W------W---W
W---------------W--W
W--X-WW-W--X-W-WW-WW
W----W--------WW--WW
WW----------XWWW-W-W
W--W--------------WW
W------------------W
WW----W--W-W-------W
WW--W--XWW----WW---W
W---WX--------W----W
W-W-W--------------W
W----W-W-----W-----W
WW--W-WW-----------W
WW---W--W-------W--W
WWWWWWWWWWWWWWWWWWWW
