WWWWWWWWWWWWWWWWWWWW
W---W-----W-W------W
W----W--WW--W-X----W
W----W---------W---W
W--WW--W-----WW--W-W
WXW------W-----W-W-W
W---------------W--W
W--W--------W---WW-W
W----W--------W---WW
W-W-W---W------W---W
W------WW----------W
W-----W---W--W----WW
W---------------W--W
W-------W-W-WW-----W
WW-----WX--------X-W
W-W-----WWW-W---W--W
W-W-W-W-W----W-W---W
W----WW------------W
W--------W-------W-W
WWWWWWWWWWWWWWWWWWWW
