WWWWWWWWWWWWWWWWWWWW
W----WWW----W-W----W
W--------X---------W
W-------W----W-----W
W-W-------X-X--W-W-W
W-X---W--W---------W
WX-------W-W--W---WW
W----------------X-W
W-WX---W-X----X----W
W-----------W----W-W
W---X--W--------W-WW
W-W--W--WX-W-W-----W
W-----W--W----W----W
W------------------W
W-W--WWW-----W-----W
W-----W------W-X---W
W--X-----WWX---W---W
WW-------------W-W-W
WW-W---W-----W-----W
WWWWWWWWWWWWWWWWWWWW
