WWWWWWWWWWWWWWWWWWWW
W------------WW----W
W-----W------W---W-W
W---WW--W------W--WW
W-W--W-W-WWW-------W
WW----W------WX---WW
WW-------W---W-----W
W------WW------W---W
W-W----------------W
W----W--W---W---W--W
W------------------W
W-W----W-----------W
W-----XW------W----W
WWW-W--W----W---W-XW
W------W--------W--W
WX-W------------W--W
W----W-----------W-W
WW------W-WW-----W-W
WX-W---W--W--------W
WWWWWWWWWWWWWWWWWWWW
