WWWWWWWWWWWWWWWWWWWW
W---WWW-----X-W----W
W-------------W----W
W------------W-----W
W--------W---------W
WX--------X--------W
W------W-----------W
W-----W-----W-----WW
WX---W-----W-------W
W--W-WX-----W------W
W------------------W
W------W---WW------W
W-W---------WW-----W
W-W----------------W
W--------WW--------W
WW-------W--X---W--W
W---W--X--W--------W
WWW-------XW-WW-XWWW
W--W----W------WW--W
WWWWWWWWWWWWWWWWWWWW
