WWWWWWWWWWWWWWWWWWWW
W----W-W-W-WW------W
W-----------------WW
W---------W-WW----XW
WW---WW------X-WW--W
W--W-W----W------W-W
WW------W----X--X--W
W-W---WX-----X----WW
WW------W-W----W-WWW
W--W-W-X-------W---W
W---W-W--W---WWW---W
WW-W-W---W------W-WW
W-W-----------W-W-WW
W-W-X--WWWWX----W--W
W---WW----------W--W
W--------W----WX--WW
W-XW-W-W--W----W---W
W--------------X--XW
W---W---------W----W
WWWWWWWWWWWWWWWWWWWW
