WWWWWWWWWWWWWWWWWWWW
W----W-------------W
W---W-------W------W
W-----W--W---W-----W
W-W---W--X-W-WW--WWW
WW--WWW------------W
W-W-------------W--W
W-----W--------WXX-W
W----W-------------W
W-------W--W-W----WW
W--W---W--W---WW---W
W--------------WW-WW
W----------------W-W
W----W-------W-----W
W--------W---------W
W---W--------------W
W-------W--W-------W
W----W-X-WW-----WW-W
W---W---------W----W
WWWWWWWWWWWWWWWWWWWW
