WWWWWWWWWWWWWWWWWWWW
W-------WW---------W
W------------------W
W---W-WW----W-W---WW
W-W------W--W-W----W
W-X--W-----X-------W
WW----W------------W
W---W---W----W--W--W
W----------W---W---W
W-------------W--W-W
WW--W-W----W-W-----W
W--W-------------W-W
W---W-W------------W
W---------W---W----W
W------W----W------W
W------W-X---------W
W--W----W--W-W-----W
W------------------W
W---------------WW-W
WWWWWWWWWWWWWWWWWWWW
