WWWWWWWWWWWWWWWWWWWW
W-----W-W-W-------WW
W-------XW---------W
W---W-----W---W-W--W
WWWW-W----W------WWW
WW--W---WW--W--WW--W
WW--W-WW-----W-----W
W--W--W----W-W--W--W
W----X------W--W-X-W
W-------W-----W---WW
W---------W----W---W
W---WW-------W-----W
W--W--W----W-------W
W---WW-WW---WW-----W
W-------------WW---W
W-W--------W----X-XW
W-W-W---WX-WW--W---W
WW---------W--W-W--W
W----WW--W---------W
WWWWWWWWWWWWWWWWWWWW
