WWWWWWWWWWWWWWWWWWWW
W---W----W-W-------W
W---W-W-X-WWW-W--W-W
W------W--W---X----W
W-----W---W--W-----W
W-W--W-------------W
W--W---WWW---------W
W----X------W---X-WW
W-W-W-----W-------WW
W---X-W-W--WWW---WWW
W--WW----W-W--W-W--W
WWW-----WW-X---WW--W
W----------W--X--WWW
W-W--W--W-W-W---W--W
W-W-----WW--W------W
WX---W-WWX---------W
W---W-W-WWW-------XW
W---------W-X--WX--W
W--WWW-----------W-W
WWWWWWWWWWWWWWWWWWWW
