WWWWWWWWWWWWWWWWWWWW
W------WW---W--W---W
W---WW---------W---W
W----------W--W----W
W--W----W--WW------W
W-X-X---------WW---W
W-W-----------W----W
WW---W----W-W------W
W-WWW------W-------W
W------------WW----W
W--------XW--WW---XW
W-----X-----W------W
W---W----------W--WW
W-------------WW---W
W------W---------W-W
WW-W-------W-W-W--WW
W-W----------------W
W-----------W-WW---W
W---W-W-----------WW
WWWWWWWWWWWWWWWWWWWW
