WWWWWWWWWWWWWWWWWWWW
W-----X---W----W---W
W------WX----------W
W-----------W---W--W
W--------X--W------W
W--------------X---W
W-WXWW-X----WW--W--W
W-------X---W------W
W-----------------WW
W-----X------W-----W
W---------------W--W
W------------------W
W-------W------WWW-W
W-----W-W-------W--W
W---------X--------W
W---W--------W-----W
W------------------W
W-----X--------WW--W
W---WWX-----------WW
WWWWWWWWWWWWWWWWWWWW
