WWWWWWWWWWWWWWWWWWWW
W------X-----WXWW-WW
W---------W--------W
W-----------XX-----W
W---W--W---WX-WW---W
WW---W---W---WW----W
WW--W----W-W--W---WW
W---W---WWWW---WW--W
W-W--X-W--------WWWW
W---WW-------------W
W-X-----WX-----W-WWW
W-W--W--WWW--W--WW-W
WW---W--------W----W
WWWW--W--WW--X--W--W
WW--------W--X----WW
W----------W-X-----W
W--W----W-W-W--W-WXW
W-X--WW--W-------W-W
W--W-W----WWW-W-W--W
WWWWWWWWWWWWWWWWWWWW
