WWWWWWWWWWWWWWWWWWWW
W-------W--------W-W
W---W--------------W
W---------W---W----W
W---W--W---------W-W
W-WX-X----X-X-W-W-XW
W------XWXW--WX-W--W
WWX--X---W--W----WWW
W----X----XW--WW-W-W
W-----W----W---W---W
W--W---W---WW----W-W
WW-W---------------W
WX-W-----W-----W-W-W
W--W-----W--WW-----W
W-----WWW----X--W--W
W----WWW-----------W
W-------W---X-----WW
W----WWW-WW--W-----W
W---WW----W-W------W
WWWWWWWWWWWWWWWWWWWW
