WWWWWWWWWWWWWWWWWWWWWWWWWWWWWW
W-----------W----------------W
W-----------W----------------W
W-----------W----------------W
W-----------W----------------W
W-----------W----------------W
W----------------------------W
W----------------------------W
W----------------------------W
W----------------------------W
W----------------------------W
WWWWWWWW---------------------W
W----------------------------W
W----------------------------W
W----------------------------W
W----------------------------W
W----------------------------W
W----------------------------W
W----------------------------W
W----------------------------W
W----------------------------W
W----------------------------W
W----------------------------W
W-----------------X---------XW
W----------------------------W
W----------------------------W
W-----------------------X----W
W----------------------------W
W-----------------X---------XW
WWWWWWWWWWWWWWWWWWWWWWWWWWWWWW
