WWWWWWWWWWWWWWWWWWWW
W------------------W
W------------------W
W----WWWWW-W-WWWW--W
W------------WW--XXW
WW-W----W----WWWWW-W
W--W---WW----W-----W
W--WW-WW--WWWW-----W
W--W---W--W----WWW-W
W--W---W-WW-------XW
WWWW---W--W-W------W
WW--W--W--W--------W
W-----WW--W-W--WWWWW
WXWWWW-W-------W---W
WWW--------WW--W---W
W---W---W-W-W--W---W
WW-W---WW----WWW--XW
W----------W---WW-WW
W-X-----------------
WWWWWWWWWWWWWWWWWWWW
