WWWWWWWWWWWWWWWWWWWW
W------------------W
W------------------W
W----W-------------W
W----W--W---WW-WW--W
W-WW----W----------W
W-W---WWW-W-WWWW--XW
WWW-W-W------------W
WWW---W----W-WWWW-WW
WWW---W----W--W----W
WWWWWWW--W----W----W
W------------WW----W
W----WWW--W----WWX-W
W--W---W--WWWWW----W
W--W---W--W--------W
WX-W--WW--WW--WW---W
WW----W--WW--------W
WW----WWWW-------WWW
W------------WW----W
WWWWWWWWWWWWWWWWWWWW
