WWWWWWWWWWWWWWWWWWWW
W------------------W
W------------------W
W----W------WWWWWW-W
W------WXWW--------W
W-----W------WWW--WW
W--------WWWW-----WW
W---WW-W----------WW
W---X--WW-W--WW----W
WWWWWWWW--W--------W
W------W--WW-WW----W
WW--W--W------W-W--W
W------W------W-WX-W
WW-XW-WW-WWW--W----W
WW----X-------W----W
W-----WWWWWWWWW----W
WWW--W-------------W
W------------WWWW--W
W------------------W
WWWWWWWWWWWWWWWWWWWW
