WWWWWWWWWWWWWWWWWWWW
W------------------W
W------------------W
W----W----W-W------W
W----W--WWWWWW--W-XW
W----W----W--------W
W----W-------W-----W
W---WWWW-----W-WWWWW
W---------WWWW-----W
W-W-WW-W----------WW
W-WWW------WWWWWW-WW
W------XW--W------WW
WW-WWWWW------W---WW
W--W--------WW-----W
WW-WW---W-WWW------W
WW---WW-W----------W
WW--WW----WW-W----XW
WW--WWWWWW------WWXW
W------------------W
WWWWWWWWWWWWWWWWWWWW
