WWWWWWWWWWWWWWWWWWWW
W----------------W-W
W------------------W
W----------W---W---W
W-----W--W----W----W
WW-------W---------W
W--WWWW--W----WWWW-W
W------W-W-------WXW
W---W--W-W--WW---W-W
W---W----W--WW---W-W
W---W---WWWW-------W
WW---------------W-W
WWW--WWWWW--W------W
WWW--WW--W------W--W
W--------W----W-W--W
W---W----W----W----W
W-W-W-W--W--WWW--WWW
WX----W--W---------W
W-------------W---XW
WWWWWWWWWWWWWWWWWWWW
