WWWWWWWWWWWWWWWWWWWW
W------------------W
W------------------W
W------W---------WWW
W-----------WW-----W
WW-WWW----WW----WW-W
WW-W-------W----WW-W
W-----------WW--W-XW
WWWWWWWWW-WWWW--WW-W
W------------------W
WW---WWWWWW--------W
WWW---------------WW
W---WWW------------W
WWW--------W--WWW--W
W----WW------------W
WWWWWW----WWWW----XW
W-------W------W---W
W-----WWW--W---W--XW
W------------------W
WWWWWWWWWWWWWWWWWWWW
