WWWWWWWWWWWWWWWWWWWW
W------------------W
W------------------W
W---------W-WW-W--XW
W----WX--------W--WW
W---WWW---WW-W----WW
WW-----------WW--WWW
W-WWWW--W----WW-W-WW
WWW----------------W
W-W-WW-----W-WWWW--W
W---------WW-------W
W------------W--WWWW
W-W----W--W--WW-WWWW
W-W-------------WW-W
W--W-------WW------W
WWWWWW---W--W-W--XWW
W--------W----W----W
W------------------W
W------------------W
WWWWWWWWWWWWWWWWWWWW
