WWWWWWWWWWWWWWWWWWWW
W-----------------WW
W------------------W
W-------W-----W----W
W------WW-----W----W
W---W---------W----W
WW-----W--WW-------W
W------W---W---W-W-W
W--W---W------WW---W
WW-------WW---W----W
WW--WWX-------WWW--W
WW---WWWW-WWW-W----W
WW--W-WWW----X-----W
WW--W--WW--W--W---XW
W--W---------------W
W--W-WWW------WW---W
W--W------WW--W----W
W------------------W
WWXWW--------------W
WWWWWWWWWWWWWWWWWWWW
