WWWWWWWWWWWWWWWWWWWW
W------------------W
W------------------W
W-----W----W-WW---XW
W-----X----W-W---WXW
WW--WWWWWWW--WWWWW-W
W------------------W
W--WWWWW--WWWW----WW
WW--------W--------W
WW--W-WWW-W-----X--W
W---------W-WW-----W
WWWWW-W--W-W-------W
WW------------WW--WW
WW--W----W-----W---W
WW--WWWWW--W---W---W
WW--W---------WW---W
W--WWWWWWW-W-------W
WW-X---------------W
W-------------W----W
WWWWWWWWWWWWWWWWWWWW
