WWWWWWWWWWWWWWWWWWWW
W-----W------------W
W------------------W
W----W---W-WWWW----W
W--------WWWW----XXW
W-WWWW------WWWWWW-W
W---------W-WWW----W
W---------W---WWWWWW
WWW------XW----W---W
W--------WWW-W-W--XW
WW-WWW-------W-W--XW
W--W----W--WWW-WW--W
W--W-W-------------W
WW-W------------W-WW
W--W---WWW------W--W
WWWWW--------W----WW
W-W--WWW--W--W-----W
W---------X--W-----W
W------------------W
WWWWWWWWWWWWWWWWWWWW
