WWWWWWWWWWWWWWWWWWWW
W------------------W
-------------------W
W------W---WWWW---WW
W-----WWW-WW-------W
WW----WW--WWW-------
WW--W-----W---WWW--W
W---W-----W-WW-W--WW
WW----------------XW
W---WWWWWW----WWWWWW
WW-W-------WWWW----W
W----WWWW--W-WW-W--W
W----W-----W-W--W--W
W----W-------------W
WWW--W--WWW--------W
WW---W------------WW
W-------W---W-----WW
W--W-WWXW--XW--WW-WW
W---------W--------W
WWWWWWWWWWWWWWWWWWWW
