WWWWWWWWWWWWWWWWWWWW
W------------------W
W------------------W
W------W-----W-----W
W-------WWWWWWWW-X-W
W---W----------WW--W
W--WW-W-----W------W
W----WWWW--XWW----WW
W--------------W---W
W---W-W----WW--WW--W
W----------W---W---W
W-W-W--------------W
W--W-WWW---WWW-----W
W-WW-----W-------X-W
W------WWW---------W
W--W---W-----------W
W-------WW--------XW
W---W------WWW--W--W
W------------------W
WWWWWWWWWWWWWWWWWWWW
