WWWWWWWWWWWWWWWWWWWW
W---------------W--W
W-------------------
W----WWWW-W----WW--W
W---------W--W-----W
WW-WW----WW--W-----W
WW------W-W--W-----W
W---WW-------WX----W
W-W-W---WWWWW-W----W
WW-WW--------------W
W----W-W-----X-----W
WWWWWW-W--W-------WW
W-----WWW-W-------WW
W----W-X------W----W
WWW--W---WWW-WWWW-XW
W-W--W-------------W
W--------W--WWWWW--W
W----WW--W---------W
W-----W-WW---------W
WWWWWWWWWWWWWWWWWWWW
