WWWWWWWWWWWWWWWWWWWW
W------------------W
W------------------W
W----W---------W---W
W----W-WWWWWWW---W-W
W-----------------XW
WWWW---WWWWWWW-----W
W------W----------WW
WWWWW--W------W----W
W-W-W--W-WW-W-W----W
W--------W---X---W-W
W----W-W--WWWWWW-W-W
W------W---------W-W
WW--WW-WW----XW----W
WW--WW-------------W
W---X------W--W-W--W
W---WW-----W------XW
W--------------WW--W
W------------------W
WWWWWWWWWWWWWWWWWWWW
