WWWWWWWWWWWWWWWWWWWW
W------------------W
W------------------W
W----W--W--W-W--W--W
W-------W--WW-WW---W
WWWWWW--WWWW----W--W
W------------------W
W---WW---W-WW-W----W
W---W---------W----W
W---WWWW--W---W----W
WW--W-----W---W---WW
W------WWWW--------W
WW--WWWW--W---W----W
W---------W-WWW----W
W---WW---WW--------W
W---------------W-WW
W---------WWW-----XW
WW-WWW------W------W
W-------X----------W
WWWWWWWWWWWWWWWWWWWW
