WWWWWWWWWWWWWWWWWWWW
W------------------W
W------------------W
W----W-------W----WW
W-----------WW----XW
WWWWWWWWWW-----WW-WW
W-----------W----X-W
WWWWWWWWWWWWW----WWW
W-----------W-----WW
WWW-----W----WWWW--W
WW-W-W-------------W
WW---------X---W---W
WWWWW-W--W-W-------W
WW----------------XW
W-----W-WWW----W-WWW
WWW-----------WW---W
W----X---W---------W
W--W---------WW---WW
W------------------W
WWWWWWWWWWWWWWWWWWWW
