WWWWWWWWWWWWWWWWWWWW
W------------------W
W------------------W
W--------W--W------W
W----WW-WW--W-----XW
W-----------W--WWW-W
W-----WWW----------W
W---------W-W--WW-WW
W--WWW---W---------W
W--W-----------X--WW
WW-W---WWW-WWWWWW--W
WW----W------------W
W-----WWWWWWWW-W---W
WWWW--W------------W
W----WWWWWW--W--WWXW
W------------W----WW
W------WW--WWW--WWWW
W--W---------------W
W------------------W
WWWWWWWWWWWWWWWWWWWW
