WWWWWWWWWWWWWWWWWWWW
W------------------W
W------------------W
W----WW---WW---WWW-W
W----------W-W-----W
W-WW--WWWW-W------XW
WWW-----------X-W--W
W-----W-WWWWW-W----W
W--W---------------W
WW----WW------W----W
W-----WW-----------W
W-X-W-----WW---WW-XW
WWWWW--W---W----W--W
W------W-----------W
WW-WW--W-----W-----W
W--W---WW--W--WWW--W
WWW--W-----W-W-----W
W---------------WWWW
W------------------W
WWWWWWWWWWWWWWWWWWWW
