WWWWWWWWWWWWWWWWWWWW
W------------------W
W------------------W
W-----WW----W------W
W----WWWW-W-WWW----W
W--W------W-W---WW-W
W--WWWWW--W--W-----W
WWWWW--------------W
WW--W----W--------XW
WW-------WW-WWW----W
WW--WWW---W--W----XW
WW--W-----W--WWWWWWW
WW--W-----W--W-----W
WW--WW-W-WW--WW----W
W--X---------W-----W
W----WWWWWWWWW-----W
W------------------W
W--------W--WWWW---W
W------------------W
WWWWWWWWWWWWWWWWWWWW
