WWWWWWWWWWWWWWWWWWWW
W------------------W
W---------W--------W
W----X----W--------W
W----W-------X----WW
WWW-W------WWW----XW
W--------W-----WW--W
WW--W----WWWWW-WW--W
WW--WW-----W-------W
W---------WWWWWWWWWW
W-WWWW----X--------W
W---------W---WWW--W
W---WWW-W-W--------W
W------------XW----W
WW-------W-W--WWW--W
W----W-WWWW-------XW
WWWW-WW-----------XW
WW-----------------W
W------------------W
WWWWWWWWWWWWWWWWWWWW
