WWWWWWWWWWWWWWWWWWWW
W-------WW---------W
W------------------W
W----W-----WWW--W--W
W----WW---------W--W
WW----W------WW-W--W
WW----W---W-----W--W
W-W-WWWWWWW--WWWW--W
W-W----------------W
W-W---WWWWWWWW--WW-W
W-W-----W----------W
W-------W---X------W
WWW--W-W-----------W
WW----WWWW-W------XW
WW-X---W--WWW---W--W
WW--W--WW-W-----W--W
WW--------W---WW---W
WW---W-W-------W--WW
W------------------W
WWWWWWWWWWWWWWWWWWWW
