WWWWWWWWWWWWWWWWWWWW
W------------------W
W------------------W
W------W---------W-W
W------W--W-WWW--W-W
WW--WWWW---------W-W
WW----------WWW----W
WWW------W--------XW
WWW-WWW-WW----WWWWWW
W--------W---------W
W-WW-WWWWWW----X---W
W-----W------------W
WW---WW------------W
W----WW-WW-W-WW-W--W
WWWW--X--WWW----W--W
W---WWW---------WWWW
W---W-------WW--W--W
W------------------W
W------------------W
WWWWWWWWWWWWWWWWWWWW
