WWWWWWWWWWWWWWWWWWWW
W------------------W
W------------------W
W------W-----------W
W-----WW---W------XW
WW--W--W--WW-------W
WWWWW--W--W-X---W--W
W------W--W--WX---WW
W---WW-W--W--WW----W
W---W-----WW-------W
W----WWW-----W-----W
W---------W--W-----W
WX--------------W--W
W------WWWWW-W--W--W
W------W--------WW-W
W--WWW-W-WWW--W----W
W--------W----W----W
W-------------W----W
W------------------W
WWWWWWWWWWWWWWWWWWWW
