WWWWWWWWWWWWWWWWWWWW
W------------------W
W------------------W
W-----W---W--WW--WWW
W-----W---W------W-W
W----------------W-W
W--W---X-WWW-W-WW--W
W--WWWWW----W----W-W
W--W-----W---------W
WW--WWW--W--WW-W-W-W
W--------W--------WW
WWW----W-W--W-----WW
W-----------W------W
W--WW-WWWW--WWWW---W
W------------------W
W-WWWWWWW-WW-------W
W------W---W--W----W
W---WWW--WW--------W
W------------------W
WWWWWWWWWWWWWWWWWWWW
