WWWWWWWWWWWWWWWWWWWW
W------------------W
W------------------W
W-------------W-WWWW
W----WW--WWW--W----W
WW-WW-----W---W--WWW
W-----W------------W
W------------W-----W
WW-W--WW-----W--WWXW
W------------WWWW--W
WWWWW-W---W--W-----W
WW-----------WWWWWWW
W-WW---WW---W------W
W-WW-----------WW--W
W-----W--WWWW-WW---W
WWWW--WW-------WWWWW
W-----WWW--WWW----WW
W--W----------XW---W
W------------------W
WWWWWWWWWWWWWWWWWWWW
