WWWWWWWWWWWWWWWWWWWW
W------------------W
W------------------W
W----------W---W---W
W----WW----WWWWW--XW
WW-------WW--------W
WW--WW---W-----WWW-W
WW----W--WWWW------W
WW--WWWWW-------W--W
W---W--------------W
WX----WWWWWW-WWWW--W
W------------------W
WW--W-------WWW-W--W
W---------W----W---W
W------W--WW------XW
WW----WW--W---WWWW-W
WW-----------------W
W---W--------------W
W------------------W
WWWWWWWWWWWWWWWWWWWW
