WWWWWWWWWWWWWWWWWWWW
W------------------W
W------------------W
W----------WW------W
W----WW-----X------W
WWW------WWWWWWW--WW
W-----------W------W
W-----------W-----XW
W----WWW--WWW------W
WW--WW-------------W
WW--------WWWWWWW--W
WWWWWWWW-----------W
WW---------WWWW-W--W
WW--W--W--W--------W
WW--W-----W----WWW-W
W--XW--W--W----W---W
W---W--W--W----W--WW
WW-----W--W--------W
W------------------W
WWWWWWWWWWWWWWWWWWWW
