WWWWWWWWWWWWWWWWWWWW
W------------------W
W------------------W
W----WWW-WWW----W-WW
W----------W-------W
W----WWWWW-W-WWWW-WW
WW-----------------W
W----W---WWWWW-----W
WW---W--W----------W
WW-----------------W
W------------------W
W--W-W---W--W------W
W------------W-WWW-W
W----WWWWWWWWW-----W
WW---W-------W--W-WW
W----W--WW--WWW----W
W----W--WW---------W
WX---W-------------W
W-----------W-----XW
WWWWWWWWWWWWWWWWWWWW
