WWWWWWWWWWWWWWWWWWWW
W--------W---------W
-------------------W
W-----W--WW---W--W-W
W-----W---WW-------W
WW-WW-WWWW---------W
WW-W-----WW-WWW-W--W
WW----WW-----------W
WW---------W--WWW--W
WWWW---W-----------W
WW-W---W-----------W
W-------WWWWW--WWWWW
WW---W--WWWWWW-----W
W-------W-------W-XW
W--W---WW---WWWWW--W
W-WW---------------W
W-----W-WWWWW-WWWW-W
W---X---W----------W
W------------------W
WWWWWWWWWWWWWWWWWWWW
