WWWWWWWWWWWWWWWWWWWW
W-----------W------W
W------------------W
W------------WWW---W
W------WWW--WW-W--XW
W--WW----------WWWWW
W-W-------W-X--W---W
WW----WW--W-W------W
W------W--W--W-WWW-W
WW-WW--WW-W--W-----W
WW-WW---W-WW-W--WWWW
WW-----WW--W-WW-W--W
W--WWWWWW--W----W-WW
WW------WW-W-------W
W---W--WWW-WWW--W--W
W---W--WW----------W
W---W-----WW------XW
W---------W-----WWWW
W------------------W
WWWWWWWWWWWWWWWWWWWW
