WWWWWWWWWWWWWWWWWWWW
W------------------W
W------------------W
W------------W-----W
W-------W----------W
W-----W-W--WWWW-W--W
W-------W--W-------W
WWW-WW--W--W-WW----W
W--------W-W-------W
WW-------W--------WW
WW----WWWW-WWW-----W
W------------------W
WW-WWWW------------W
W-------------WW---W
WWW----------------W
W-W-----------WWWWWW
W-------------W----W
W--------WW---W----W
W---------W---W-X--W
WWWWWW-WWWWWWWWWWWWW
