WWWWWWWWWWWWWWWWWWWW
W------------------W
W------------------W
W----W-WW-WWW------W
W------------------W
WW-W--------W------W
WW-WW--WWW--W------W
WW-W---W---WWW-----W
W---WWWWW-W--------W
WW--------WWW-WWW-XW
W------WWWWWW---W--W
WW-----------------W
WW-------WWW--WW---W
WW--W----------WW--W
W-----------W--W---W
W-W----WW--W--W----W
W------------------W
W---WWWWW-------WW-W
W----W-------------W
WWWWWWWWWWWWWWWWWWWW
