WWWWW--WWWWWWWWWW-WW
W----W-W-------WWWWW
-----W-----W-WWWWX-W
W----------------W--
W-----W-----------WW
W-W----WW-WWW-----WW
W-W-W----------WWWWW
WWW----WWW--W----WWW
W---W-W--W-W---W-WWW
W-----W-----W--W--WW
W-----W------W-WWWWW
WW----WW-W-----WW---
W---W-W-------WWW--W
W-WWW-WW---WW-WWWWWW
W-------------WWW--W
-----W---WW--WW-----
W-W----W-----W----WW
-------W--WWW-WWW---
--WWW------W-----WWW
WWW--WWWWWWWWWWWWW-W
