WWWWWWWWWWWWWWWWWWWW
W------------------W
W------------------W
W---------WWW---W--W
W------------------W
WW--WWWWWWW--------W
W---------W--W-----W
WWWW---W--W--W---XXW
W--W---W--W-WW-W--WW
W--W------W--------W
W-----W---W--WWWW-WW
W-W-------W--------W
W---W-------W-WWWW-W
W-------WW--W------W
W--WW-XW----WWWW---W
W--WWWWW---WW-----XW
W------------W--WWWW
W--------WW--W-----W
W------------------W
WWWWWWWWWWWWWWWWWWWW
