WWWWWWWWWWWWWWWWWWWW
W------------------W
W------------------W
W-----------W------W
W-----------W--W---W
W--W---WWW--W--W---W
W--------------W---W
W------W-WW-W--W---W
W-WW---WW---W--W---W
W-----------WW-W---W
WXW--WW-W---W------W
WXW--W---------WW--W
W----W---W-----W---W
WW--WWWWW------W---W
W-------------WW---W
W---WWWWWWW----W---W
W---W----W---------W
W---W-W--W--W------W
W------------------W
WWWWWWWWWWWWWWWWWWWW
