WWWWWWWWWWWWWWWWWWWW
W------------------W
W------------------W
W-----WWWW----W----W
W--------W-W--W----W
W-WWWWWW--WW--WW---W
W------W--WW-------W
W---------W---WWWW-W
W---------W---------
WX-------------WW--W
W--W----WWWW-W-----W
W--WWW-WW----W----XW
W-------W----WWWW--W
WWWW-WWWWWWW-------W
W------------WWW---W
W----W-------W---XXW
WW-----W--------WWXW
W-----------WWWWW--W
W------------------W
WWWWWWWWWWWWWWWWWWWW
