WWWWWWWWWWWWWWWWWWWW
W----------W-------W
W-----W------------W
W--------W---WW----W
W------WWW--WWW----W
W------------W-----W
WX---WWW-W---WWWWW-W
W--W--W------WW----W
W-----WWWWW---W----W
W------------WW----W
WW-W------W--------W
W-WW---------------W
W-W----W-WWW-WW--WXW
W-------------WW---W
W----W----W--------W
W----WWW--WWWWW----W
W-W------X---------W
W-----WWWWWWWWW----W
W------------------W
WWWWWWWWWWWWWWWWWWWW
