WWWWWWWWWWWWWWWWWWWW
W------------------W
W-----------W------W
W-----WW----W------W
W--------WW-W--W---W
W---W----W--------XW
W---W----W--W------W
WW---------WW------W
W----WWW-W--WWW----W
W---WW---WW--------W
WX---W---WWW-WWW---W
WW------WWWW-------W
W------W---WWWWWWW-W
W----------W---W---W
W-------------XWWWWW
W-----------WWWW---W
WW-W--------W------W
W-----W-W---WW-W---W
WW----------------XW
WWWWWWWWWWWWWWWWWWWW
