WWWWWWWWWWWWWWWWWWWW
W-------------WW---W
W------------------W
W------WWW-WWW-----W
W----WW-----W------W
W--WWW---WWWW-WW---W
W--WW----W---------W
W-----WWWW--W-WWWW-W
W------------------W
W-----------W------W
W----WWWWW--WW-----W
W--------W---------W
W-WWWWWW-----------W
W-------W--WW-W----W
W---XW-WW--W--WWW--W
W-------W--W--W---XW
WX------W-WWWWWW-W-W
WW--WW-----W--WW---W
W------------------W
WWWWWWWWWWWWWWWWWWWW
