WWWWWWWWWWWWWWWWWWWW
W------------------W
W------------------W
W------------------W
W----WWW-----------W
W--------WWWW------W
W------------------W
W-WWWWW-W---W-----WW
W-W-----W---W------W
W-WWWW--WWWWWW-----W
W-W-----W----------W
W------------WWW---W
W--WWWW------------W
W-W---W-WWWW-W-WW-XW
W-----W------------W
W----------------WWW
W----W----W--------W
W---------W--------W
W---------W--------W
WWWWWWWWWWWWWWWWWWWW
