WWWWWWWWWWWWWWWWWWWW
W-----------------WW
W------------------W
W--------WWW------XW
W--------W------W--W
W---W-W-------W----W
W---W------W-------W
W---W--W----------WW
W------WWW---WW----W
W-W----W----------WW
W-WW---W--------W--W
W---------WWWW-----W
W------------WWWWWWW
W-----W--W---WW----W
W-----W--W------W--W
W--W-----W--WW-----W
W--------W--W------W
W--WW-W--------W---W
W--------------W---W
WWWWWWWWWWWWWWWWWWWW
