WWWWWWWWWWWWWWWWWWWW
W----------W-------W
W------------------W
W-------W--W-------W
W-------W--W------XW
W-WWWW--W--WWWW----W
W-------W----------W
W-W-----WW-W--W----W
W-WW----W----------W
W----------W-WWW--XW
WW-WW---W-WW-------W
W------------W-----W
WW--WW-WW---WW----WW
W-----------------WW
W--W----W-W-------WW
W--W-----------W--WW
W--W------W----W---W
WW-WW-WWW----------W
W------------------W
WWWWWWWWWWWWWWWWWWWW
