WWWWWWWWWWWWWWWWWWWW
W------------------W
W------------------W
W---------W-WWW----W
W----W------W------W
W--------W-WWWW----W
W--W---WW----------W
W--WWW-------------W
W-----WW---WWW-----W
W------------------W
W---------W-WWWWW--W
WW-----W--W-----W--W
WW-W---W--WWWWWWW--W
W----WW------------W
W-----W----W------XW
WW---------WW---W--W
W---------------W--W
W----W-----WWWWW---W
W---------------WWWW
WWWWWWWWWWWWWWWWWWWW
