WWWWWWWWWWWWWWWWWWWW
W------------------W
W------------------W
W-----WW--W---W----W
W---------W---WWW-WW
WWWW------WW--W----W
WW--------W---W-WWWW
W--W---W--WWWWW----W
WW-WW--W--W--W-----W
W---W--W--WW-W-----W
W-----WWW----------W
WW--W-------WWW----W
W------WW-W--------W
W----------W---WW--W
W------W---W-------W
W-W--W-W----------WW
W-------W---------WW
W-------------W--X-W
W------------------W
WWWWWWWWWWWWWWWWWWWW
