WWWWWWWWWWWWWWWWWWWW
W------------------W
W------------------W
W-------WWWWWWWW---W
W----------W-W--WW-W
W------------W----XW
W------WWWW--WW----W
W------------W-----W
WW---WWW--W----WW--W
W----W----W--W-----W
W--W-W----W---W-W--W
W-------------W-W--W
WW---WW-------W-W-XW
WW----W-------W-W--W
WW-------W----W----W
WW-----------------W
W----------WWWW----W
W--WWWW------------W
W-------W----------W
WWWWWWWWWWWW-WWWWWWW
