WWWWWWWW-WWWWWWWWWWW
W------------------W
W-------W----------W
W------------WW----W
W-----WWWWWW----W--W
W------------------W
WWWW-W-----W-WWWWWWW
W----W----WWWWW----W
WW--XW---X---W--WWWW
WWWWWW-WWW------W--W
W----WWW-------WW--W
W----WW---W--------W
W---XW-W-WW-------WW
W--W---W-W---W-----W
WWWW--------WW-W---W
WWW----------------W
W-W-----WW---------W
W------------------W
W------------------W
WWWWWWWWWWWWWWWWWWWW
