WWWWWWWWWWWWWWWWWWWW
W------------------W
W------------------W
W------W-WWW---WW--W
W----W------W------W
W-----------W-----XW
W--WW-W-W--W--WWWWWW
W--W--W----W--W----W
W-----WWWWWW--WW---W
W-----W--W---------W
W-----W--W---------W
W-----W-----W--WW--W
W---------W-W------W
W-----W--WW-WWWW---W
W--------W--------WW
W--------WW-W------W
W-WW--WWWW------W--W
W-----X-----WW-WW--W
WX-----------------W
WWWWWWWWWWWWWWWWWWWW
