WWWWWWWWWWWWWWWWWWWW
W------------------W
W------------------W
W----W--W--WW-WW---W
W-------------W----W
WWW-WWWWWW-WWWWW-W-W
WWW--W-------------W
W---WWW-WWWWWWW--WWW
W----W---W---------W
WW---W--WWWWWW----XW
W----W--W-------W--W
W---W--WW--W-------W
W------W---W--WW-WWW
W------------WW----W
W-------WW---------W
W-WW--------WWWW--XW
W----WWWWWW---W----W
W--------W--WWW--W-W
W---W--------------W
WWWWWWWWWWWWWWWWWWWW
