WWWWWWWWWWWWWWWWWWWW
W------------------W
W------------------W
W-------W-W---WW--WW
W-----------------WW
W---W--WW----W----WW
W--W-----------WW--W
W----------W-WWWW--W
WWWWW-----------W-XW
W---W--------WWWW--W
W--WW--X-----------W
W----WWW-------W-W-W
W------------------W
W------WW------WWW-W
W------------------W
W--------------WW--W
WW-----------WWW---W
WW-------W---------W
WW-----------------W
WWWWWWWWWWWWWWWWWWWW
