WWWWWWWWWWWWWWWWWWWW
W------------------W
W-------------------
W-----W-----W-----XW
W-----W---W--W---WWW
W---W-----W--W-----W
WW--W------WWW-----W
W---W-W------------W
WW--W----WWWWWW--WXW
W---W----W---WW----W
W---W-WWW---WWW----W
W---WWW-------W--W-W
W----------------W-W
W---WWWWW--------W-W
W-------W--WWW-----W
WWW-WW-------------W
W-------WWWWW------W
W--------W-WW---WWWW
W------------------W
WW-WWWWWWWWWWWWWWWWW
