WWWWWWWWWWWWWWWWWWWW
W-----W------------W
W------------------W
W---------------W--W
W-----WW--------W--W
W------------------W
W--W---------W--W--W
W--W--W------W--W--W
W-W-------------W--W
W---------------W--W
W------------W-----W
W-WW-WW------------W
W--WWW---------W---W
WWWW---WWWWWW------W
W-----------------WW
WW-----WWWW--------W
W-----W------------W
WWW---W--W---------W
W-----------------XW
WWWWWWWWWWWWWWWWWWWW
