WWWWWWWWWWWWWWWWWWWW
W------------------W
W-------------W----W
W---------W-------XW
W---------W--WWWWWWW
W---------W--W-----W
W-------W----W--W--W
W--WW---WWW--W-----W
W--W---------------W
WWWWW-WW----WW--W--W
W------------------W
W----------X--WW---W
W----WWWWWWW---W---W
W----------W-------W
W-WW-WW-W----------W
W-------------W---WW
W--WW-----WW-------W
W-----W-WW---------W
WW-------W----WW---W
WWWWWWWWWWWWWWWWWWWW
