WWWWWWWWWWWWWWWWWWWW
W------------------W
W------------------W
W------------------W
W----W------WWWWW-WW
WWW---------------WW
WW-----W----W-WWWWWW
W-WWW----------W---W
W------W-XWWW--W---W
WW--WW-WW---W-WW---W
WWWWW--WW---W------W
WW---W-----W---W---W
WWWW--------------WW
W-----WWW---WWWWW--W
WW-------------W---W
WW--WW--WWW-----W--W
W-----------W--W---W
W---W---W---W------W
W------------------W
WWWWWWWWWWWWWWWWWWWW
