WWWWWWWWWWWWWWWWWWWW
W-------------W----W
W------------------W
W-----W------W-----W
W--------WW-----W--W
WW--W--WW-------W--W
WW--W--W---WW---W-XW
W---W---WW-----WW--W
WW----------W-WW---W
W------WWW-WW------W
W-----------------WW
W--------------W---W
W-----WW----------WW
W------------W-----W
W--------W-----W--WW
W--------W-----W---W
WW------------WW--WW
W--W-------W-WW---WW
W------------------W
WWWWWWWWWWWWWWWWWWWW
