WWWWWWWWWWWWWWWWWWWW
W------------------W
W------------------W
W-------W--------XWW
W--------------W---W
W---W--------------W
W-------W------W---W
W----W----WWW--W--XW
W----------W---WWWWW
W--W--------------WW
W--W-------W--W---WW
W--W-------W-------W
WWWWWWWW--WW---W---W
WW-----------------W
WW-WWW--W----------W
W-------W----------W
W----W--W----------W
W---WW-WWW---------W
W---W--------------W
WWWWWWWWWWWWWWWWWWWW
