WWWWWWWWWWWWWWWWWWWW
W---------W--------W
W------------------W
W--------------WW--W
W-----W--W-----W--WW
WW----W--W-WW------W
W-----W--W----W---WW
W-WW--W-WWWWW-W----W
W----WWW-----------W
WWW------WWWWWWWW--W
W----W------------WW
W-------------W---WW
W--------W---WW----W
W-W------W---------W
W----W---WWWWWWWW--W
W----WW-W----------W
W-------WW---------W
W----W-WWW--W-----XW
W------------------W
WWWWWWWWWWWWWWWWWWWW
