WWWWWWWWWWWWWWWWWWWW
W------------------W
W------------------W
W------W--WW-------W
W------W--WWW------W
WW-WWWWWW--W-------W
W-----------W-W----W
W---WWWWWW----W----W
W--W----------W--W-W
W------W--WW-------W
W--WWW------WW-----W
W-------W------W--WW
W---WWWWW--WW--W--WW
WWW------W-W---W---W
W--W---------WWW---W
W--W--WWWWWW--WWW--W
W--W----------W----W
W--W--WWW---WWW----W
W----------------X-W
WWWWWWWWWWWWWWWWWWWW
