WWWWWWWWWWWWWWWWWWWW
W------------------W
W------------------W
W-----WW--W--------W
W------W--WWWW-----W
W-----WWW---W------W
W-----------WWWWW--W
W--------W---------W
W-----------W-----XW
WWW----------------W
WW----------------XW
W----W-------------W
WW-W-----WWWWW-----W
W--W--W------------W
W-----WW----W-----XW
WW--W----WWWWW-WWWWW
WW-----------------W
W--------WWWWWW----W
W------------------W
WWWWWWWWWWWWWWWWWWWW
