WWWWWWWWWWWWWWWWWWWW
W---W---------WW---W
W---W-W-W------W---W
WW-X-----W-WX------W
WWX-W-W-------WX-WWW
W-----------W-W----W
W--W------W--WW-WW-W
W--W-----W--W------W
W------------------W
W-----XW-----------W
W-----X---X------W-W
W-------------W--W-W
W--------W-W---W---W
WW---WX------W-----W
W-W--------W--XX--WW
W---W--W--W-X------W
W-W--W---W---W---W-W
WW--W--------X-WW--W
W-W-W-WX-----------W
WWWWWWWWWWWWWWWWWWWW
