WWWWWWWWWW
W--------W
W--------W
W-X-----XW
W--------W
W--X-X---W
W--------W
W--------W
W----X-X-W
WWWWWWWWWW
