WWWWWWWWWW
W--------W
W--X-----W
W--------W
W---X----W
W--------W
W------W-W
W------W-W
W--------W
WWWWWWWWWW
