W--W--W---------WW--
----W------W-----W--
-------------------W
--------------------
--W----W------------
---W---W-----W------
-WW---------------W-
--------------------
---W-----------W----
--------------------
--------------------
--------------------
--------------------
--------------------
--------------------
--------------------
----------------X-X-
----------------X-X-
-----------------X--
--------------------
