WWWWWWWWWWWWWWWWWWWWWWWWWWWWWWWWWWWWWWWWWWWWWWWWWWWWWWWWWWWWWWWWWWWWWWWWWWWWWWWW
WD--------W--------W---------W-----W-WW---------W--------W---------W---------W-W
W---------W------------------W----W-W-----------W-----------------W---------W-WW
W-----------WWW------X-------------X--W---------W--------W---------W--------W--W
W---------W--------W------------------W--------------------------------------WWW
W---------W------------------W-------------------W----------------------------WW
W---------W------------------W--------W---------------W------------W-----------W
W---------W------------------W------------------W------------------X----------WW
W-W-------W--------W---------WW-WWW----------------------WWWW------W--------W-WW
W------------------W---------W------------------W---------------------------X--W
W-WWWW-----------------------W-------WWWWW------W-------WWWW-------W--------WW-W
WW---W-------------------------------WWWWW------W--------W-------WWWWW------W--W
WW--------W------------------W-------WWWWW-------------------------W-----------W
W-W-------W-----X--W----------------------------W----------W-------W--------W--W
W----------------------------W-------------------------------------X---------W-W
WWWWWW-------------W---------W------------------WW---------W-------W---------WWW
W---------W--------W---------WWWW---WWW------------------W---------------------W
W---------W---------------------------W---------WWWWW--------------W-----------W
W---------W--------W------------------W---------WX------WW---------W---------W-W
W---------W------------------W----W-W-----------W-----------------W---------W-WW
W---------W--------W---------W------------------W------------------------------W
W-WWWW---WWW-----------------W-------WWWWW------W-------WWWW-------W--------WW-W
WW--XW----W--------------------------WWWWW------W--------W-------WWWWW------W--W
W---------W-------------------------------------W------------------W----------WW
W-W-------W--------X---------WW-WWW----------------------WWWW------W--------W-WW
W---------W--------W---------WWWW---WWW------------------W-------------------X-W
W---------W-----------------------X---W---------WWWWW--------------W-----------W
W------------------------------------------------------------------------------W
W-----WWWWWW-----------------W--------W---------------W------------W-----------W
W---------W--------W------------------W--------------------------------------WWW
W---------W------------------W-------------------W----------------------------WW
W---------WX-----------------W--------W---------------W------------W-----------W
W---------W--------W---------WWWW---WWW------------------W---------------------W
W---------W---------------------------W---------WWWWW--------------W-----------W
W------------------------------------------------------------------------------W
W---------W--------W---------WWWW---WWW------------------W---------------------W
W--WWWW---W---------------------------W---------WWWWW--------------W-----------W
WWW--------W-------XW------------------W---------WX------WW---------W----------W
W-------WWW------------------W----W-W-----------W-----------------W---------W-WW
W------------------W---------W------------------W------------------------------W
W----WW------------------WW-------------------------------WW-------------------W
W---------W-------------------------------------W-----------------------------WW
W-W-------W--------W---------WW-WWW----------------------WWWW------W--------W-WW
W---WW-------------W---------W------------------W------------------------------W
W--WW-WW--W------------------W------------------W-----------------------------WW
W-W-----WWW--------W---------WW-WWW----------------------WWWW------W--------W-WW
W------------------W-------------------------WW---------------------WWW--------W
W------------------W---------W------------------W------------------------------W
W----WW------------------WW-------------------------------WW---------X---------W
W---------W-------------------------------------W-----------------------------WW
W---------W-------------------------------------W-----------------------------WW
W-W-------W--------X---------WW-WWW----------------------WWWW------W--------W-WW
W------------------W---------W------------------W------------------------------W
W-WWWW------WWW--------------W-------WWWWW------W-------WWWW-------W--------WW-W
W----------W--------W----------------------WW----------------------------------W
W---------W-------WWWWW----------------W---------WWWWW--------------W----------W
W--------W-------WWW-WWW-------------------------------------------------------W
W---------W-------WWWWW-------WWWW---WWW------------------W--------------------W
W-WWWW-----W---W----W---------W-------WWWWW------W-------WWWW-------W--------WWW
WW--XW------WWW----------------------WWWWW------W--------W-------WWWWW------W--W
W---------W-------------------------------------W------------------X----------WW
W--------------------------------------------WW---------------------WWW--------W
W------------------W---------W------------------W------------------------------W
W------------WWWW-----------------------------------WWWWWWWWWWWWWWWWWWWW-------W
W--------------W-----------------------------------W--------------W-------W----W
W-----------------------------------------WW-----------------------------------W
W---------W---------------------------W---------WWWWW--------------W-----------W
W------------------------------------------------------------------------------W
W---------W------------------W--------W---------------W------------W-----------W
W---------W--------W------------------W--------------------------------------WWW
W------------WWWW----------------------------------WW--------WW----------------W
W--------------W-----------------------------------W--------------W-------W----W
WW--XW-------------------------------WWWWW------W--------W-------WWWWW------W--W
W---------W-------------------------------------W------------------W----------WW
W--------------------------------------------WW--------------------XWWW--------W
W------------------W---------W------------------W------------------------------W
W---------W-------------------------------------W-----------------------------WW
W-W-------W------------------WW-WWW----------------------WWWW------W--------W-WW
W--------WWW--------W-W----------WW-------------------W------WWWWW-------------W
WWWWWWWWWWWWWWWWWWWWWWWWWWWWWWWWWWWWWWWWWWWWWWWWWWWWWWWWWWWWWWWWWWWWWWWWWWWWWWWW