WWWWWWWWWWWWWWWWWWWW
W------------------W
W------------------W
W------------------W
W------------------W
W------------------W
W-W----------------W
W-W----------------W
W----------WWWWW---W
W----------WWWWW---W
W----WWWWWWWWWWWWWWW
WX---WWWWWWWWWWWWWWW
W----WWWWWWWWWWWWWWW
W----WWWWWWWWWWWWWWW
W----WWWWWW----WWWWW
W----WWWWWW----WWWWW
W---WWWWWWW----WWWWW
W-W-WWWWWWWWWW-WWW-W
W-W-WWWWWWWWWW-----W
WWWWWWWWWWWWWWWWWWWW
