WWWWWWWWWWWWWWWWWWWW
W------------W---W-W
W-------W----------W
W------X-----W----WW
W-----W--WWX-----W-W
W-------------X---WW
W-W----W--W-W------W
W-W-----W----W-----W
W------W----------WW
W--------W-W---W-WWW
W-W---------------WW
W-------W----W-W-W-W
W------------------W
WX-W-------W-------W
W------------------W
W-WXW---------W---WW
WW--W-------W--WW--W
W----W---W---------W
WWWW------W-W-W-WW-W
WWWWWWWWWWWWWWWWWWWW
