WWWWWWWWWWWWWWWWWWWW
W-----W-------W----W
W-----W-----W--W-W-W
W------------------W
W-W--WWW----W------W
W---W--W--W---W--W-W
W-W--W-W-W------WW-W
W-W---W----W-------W
W----WW------------W
WW---W----W-W--W---W
WW----W-W--W-----W-W
W----WW---W-W------W
W--W--W--W-W--W--W-W
WW-----X--WWW---W--W
W-----W-----W---W--W
W--W------WW---WX--W
W--------WWW-------W
W---W--W--------W--W
W----W---W--W-W----W
WWWWWWWWWWWWWWWWWWWW
