WWWWWWWWWWWWWWWWWWWW
W----W----WW-----W-W
W------W-----------W
W-------------W----W
W----W-------------W
W-W-W-----------W--W
W-X-------------WW-W
W----W-------------W
W----------W-------W
W--W---W-------WW--W
W--W------WW-------W
W------------------W
W---W--W----W---W--W
W---W------W----W--W
W----------------XWW
W-----------------WW
W------------W-----W
W--------------W---W
W-W----W---W-------W
WWWWWWWWWWWWWWWWWWWW
