WWWWWWWWWWWWWWWWWWWW
W----------------W-W
W----W-------W-----W
W---W---W-X--------W
W---W----W--W------W
W----W---WW------W-W
W-X-W-W--W---WWX---W
WW--------W-XW-----W
W-------X------W---W
WW-W---W-------W--WW
W--W----XW-----W---W
W----W-----W-------W
W-W---W-------XWW-WW
W-----------------WW
W------------------W
WWW--W-------------W
W--W--WWW-----W-W-WW
W-W----W-W-------W-W
W---------------W--W
WWWWWWWWWWWWWWWWWWWW
