WWWWWWWWWWWWWWWWWWWW
W----X--X----WW----W
W----WW-----W-W----W
W----W-WW-W---W---WW
W-----W-----WW-W--WW
WW---W----W-----W--W
W-----W------------W
W-------WW------WW-W
WW--W--WW------W---W
W------------------W
W--W---W----W------W
W---W---W----------W
W-------W-W---W----W
W-----W------WW----W
W----------W-W--W--W
W--W-----W-W-WW---WW
W----W---W----W---WW
W-W----------W-W-X-W
W-X-------W-W------W
WWWWWWWWWWWWWWWWWWWW
