WWWWWWWWWWWWWWWWWWWW
W------------------W
W----------WWWWW---W
W----------WWWWW---W
W------WWWWWWWWW---W
W------WWWWWWWWW---W
W------WWWWWWWWWWWWW
W------WWWWWWWWW---W
W----WWWWWWWWWWWXWWW
W----WWWWWWWW----WWW
W----WWWWWWWWWW--WWW
W----WWWWWWWWX---WWW
WWW--WWWWWWWW------W
WWW--WW------------W
WWW--WW------------W
W-----WWWWW--------W
W-----WWWWW--------W
W----WWWWWW--------W
W-----WWWWW---X----W
WWWWWWWWWWWWWWWWWWWW
