WWWWWWWWWWWWWWWWWWWW
W------------------W
W------------------W
W------------------W
W----------------WWW
W------------------W
W------------------W
W-----WWWW---------W
W--WWWWWWW---------W
W--WWWWWWW-----WWWWW
WWWWWWW--------WWWWW
WWWWWWW-WWW--------W
WWWWWWW-WWW--------W
WWWWWWW-WWW------WWW
WWWWWWW-WWW------WWW
WW------WWWWWW--WWWW
W-------WWWWWW--WWWW
W-------WWWWWW--WWWW
W--------WWWWWX-WWWW
WWWWWWWWWWWWWWWWWWWW
