WWWWWWWWWWWWWWWWWWWW
W--------------X---W
W--------WWWWWW----W
W--------WWWWWW---XW
W------------------W
W------------------W
W-----------WWWWWWWW
W-----WWWW--WWWWWWWW
W-----WWWWWWWWWWWWWW
W-----WWWWWW-WWW-WWW
W-----WWWWWW-----WWW
WWWW------X---W----W
WWWW----------W----W
WWWW----------W----W
WWWW----------W----W
WWWW---------------W
WWWW---------------W
WWWW-------------W-W
W-----X----------W-W
WWWWWWWWWWWWWWWWWWWW
