WWWWWWWWWWWWWWWWWWWW
W----W--------X----W
W------------X----WW
W------WW-W------W-W
WW----------WW---WWW
WW--W--W--------WW-W
W-W----W---W--WX---W
W--W---W-----W--WX-W
WW-WWWW-X----WW---WW
WW---W-W-----W-----W
W--WW---WWW---W-WW-W
W------W-WW--------W
W--W---------W-----W
W------W---W-------W
W----W----W--W-----W
WWW-W---WWW--W-----W
W--W--WW-W-W----W--W
WW----W---WW----W--W
W---W------------W-W
WWWWWWWWWWWWWWWWWWWW
