WWWWWWWWWWWWWWWWWWWW
W----W--X------W---W
W-----------W---W--W
W----W--------WW--WW
W------------------W
W----W-W-----------W
WX-X----W--------W-W
W-W-W--------------W
W-WW-----------W---W
W-W-----W-W-----W-WW
W-----W-----W------W
W--W--------------WW
WW-------X---------W
W---------------XX-W
W--------W-W-W-W---W
W---------WW-WW----W
W-W--------W-W-----W
W------W-----------W
W----WW-W----W-X-W-W
WWWWWWWWWWWWWWWWWWWW
