WWWWWWWWWWWWWWWWWWWW
W--------W---------W
W---W-W---W-----W-WW
W-----W-W--W-------W
WWW-----------W----W
WW----W-----W----W-W
W-----WW---WW-W----W
W---W---------WW---W
W-W---W---W-----W--W
W--W-W--WW---W-W--WW
W-----W--W-W--W-W--W
W------W-W-X--W-WW-W
W--------W---W-W---W
W-XW-----W----WW--WW
W-WW-W---------W---W
W--------W-W---W--WW
WW-----------------W
W----WW-----------WW
W---WW------WW-----W
WWWWWWWWWWWWWWWWWWWW
