WWWWWWWWWWWWWWWWWWWW
W--------------X---W
W------WWWWWW-WWWWWW
W-------------WWWWWW
W-------------WWWWWW
W------------------W
W----------WW------W
W-------------WW---W
W-------------WW---W
W-------------WW---W
W------------------W
W--------WWWWWW----W
W------------------W
WWWWWW---------WW--W
WWWWWWWWWW-----WW--W
WWWWWWWWWW-----WWWWW
WWWWWWWWWW-----WWWWW
WWWWWWWWWW-----WWWWW
WWWWWWWWWW-----WWWWW
WWWWWWWWWWWWWWWWWWWW
