WWWWWWWWWWWWWWWWWWWW
W------WWWW--------W
W------WWWWWWWWWWWWW
W------WWWWWWWWWWWWW
W-WWWWWWWWWWWWWWWWWW
W-WWWWWWWWWWWWWWWWWW
W-WWWWWWWWWWWWW-X--W
W--WWWWW-------WWWWW
W--WWWWW-----------W
W--WWWWW----WWWW---W
W--WWWWW----WWWWW--W
W--WWWWW----WWWWW--W
W-----------WWWWW--W
W-----------WWWWW--W
W-----------WWWWW--W
W--X----------X-W--W
W---------------WX-W
W---X-----------WWWW
W---------------WWWW
WWWWWWWWWWWWWWWWWWWW
