WWWWWWWWWWWWWWWWWWWW
W--------------WWWWW
W--------------WWWWW
W------------------W
W------------------W
W---WWW------------W
W-------------WWWWWW
W---------WW--WWWWWW
W-----WW--WW--WWWWWW
W-----WW--WW--WWWWWW
W-----WW--WW--WWWWWW
W---X-WW--WW--WWWWWW
W--WWWWW------WWWWWW
W--WWWW----------WWW
W--WWWW----------WWW
W--WWWW-----WWWWWW-W
W--WWWW-----WWWWWW-W
W--WWWW------------W
W------------------W
WWWWWWWWWWWWWWWWWWWW
