WWWWWWWWWWWWWWWWWWWW
W---------W---W----W
W-------W---------WW
W---WW--W--W-------W
WW-W--W-W--W-------W
W-W-W-----------W-XW
W-W-------X--WW-X-WW
W-------W--------W-W
W-W-W-------W------W
WW----W------W-----W
WW------WW------W--W
W----W--W--W------WW
W-W-------W-------WW
W---------W-W------W
W----WW---W------WWW
W----W-----W-------W
W--W------W--W-----W
W----W---WW--W-----W
WW-W---W----------WW
WWWWWWWWWWWWWWWWWWWW
