WWWWWWWWWWWWWWWWWWWW
W------W-----W---WWW
W---W-----WW--W----W
W----W---WX--------W
W----W-----W-------W
W------W---WW-W----W
WW----W--XW--WW----W
WW----X-W------W-W-W
W--W------WW-------W
WWW-W--WWWW--------W
WWW--WW-W----------W
WX--W-----W--------W
WW---W----------WW-W
W-------WW-----WW--W
W-----W----------WWW
W-W--W--W-----W--W-W
W-W-WWW--W------W--W
WWW----W-W---------W
WW---WWW--------WW-W
WWWWWWWWWWWWWWWWWWWW
