WWWWWWWWWWWWWWWWWWWW
W---W-----W--W-----W
W-------W-----W----W
W-----WWW---W--W---W
W-------W-WW------WW
W--------------W---W
W-W------------W-W-W
W------------W-----W
W----W-----W---W-W-W
W--------WW------W-W
W----XX---W-W------W
WW---W-WW---WW--X--W
WW------WW---------W
W--W-W-W--W-W------W
W-W-W--W--W-X------W
W---W-W------------W
W-XW---WW--W-----W-W
W-XW--W-WW----WW---W
W---W---------W-W--W
WWWWWWWWWWWWWWWWWWWW
