WWWWWWWWWWWWWWWWWWWW
W------W-----WW----W
W------------------W
W------------------W
W-------W-----W---WW
W--WWWW-------W---WW
WW-W-W-W--W--------W
W---WW----------W--W
W-WW--------W------W
W-W------W---------W
W--W---W---------W-W
W----------W----W--W
W--XW--W------W----W
W-----W------------W
W----------W-------W
WW-W--W-------X---WW
W----------W--W----W
W----------------WWW
W--WWW--W------W---W
WWWWWWWWWWWWWWWWWWWW
