WWWWWWWWWWWWWWWWWWWW
W----WW-W----------W
W-----W------W-----W
W-------W--W--WW---W
WWW-WW-------W-----W
W----W-W-W---W-----W
WW------W------WW--W
W-W-W--W------WW--WW
W--WW---W---WW-----W
W---------WW---WW--W
W-----------W------W
W--WW-------W-W----W
W---W----WW-WW-----W
W--------W-W-W--X--W
WW-WX-W-----W-----WW
W-W----WW---WWW---WW
W------W------WWWW-W
W----------W-------W
W--W----------W----W
WWWWWWWWWWWWWWWWWWWW
