WWWWWWWWWWWWWWWWWWWW
W--------------W--WW
W---WW---------W---W
W-----W----W-------W
W---------W--W-----W
W------------------W
WWWW---X-------X---W
W--------W---W-W---W
W-----W--W-W---W---W
W---WW----W---W--W-W
W-WX------W----W---W
W--------W---------W
WW------WXW-------WW
W-------------W---WW
WWWW-------WW------W
W-W--W-W------W----W
W------W-----------W
W--------W-WW--W--WW
W--W--W-----WW----WW
WWWWWWWWWWWWWWWWWWWW
