WWWWWWWWWWWWWWWWWWWW
W----W------WWWW---W
W--------------W---W
W----W----X---W----W
W------------------W
W---------WWW-WX---W
W--W-----------W---W
W--------W---X-WW--W
W---------W--W-----W
W-XW---------------W
W--------W-W-W----XW
W---W-WW----W------W
W------------------W
W----------W-W-----W
W----W----X--W-----W
W--------W-W-W-----W
W----------W-------W
W------------W-----W
W--------W-W-------W
WWWWWWWWWWWWWWWWWWWW
