WWWWWWWWWWWWWWWWWWWW
W----W---W---------W
W-----XW----W------W
W-----W----W---W---W
WW---------WW------W
W------------W-W--WW
W--W---X--W--------W
W----W------------WW
W--W-------------WWW
W-----W--W--W--W---W
W--------------W---W
W------------------W
W------W--------W--W
W-X------W---------W
W-W-----W-WW--WW---W
W-WX-W-----W--W---WW
W----W--W----------W
W----XW------------W
W----W-----W-------W
WWWWWWWWWWWWWWWWWWWW
