WWWWWWWWWWWWWWWWWWWW
W-------WX---------W
W---W-----W-------XW
W----------W---W---W
W-------------W---WW
W---W----------W---W
W--------------XW--W
W------WW------W-X-W
W-------W----W-----W
W-W-W----W-WW------W
W--W-----W------W--W
W-------W--X-------W
W----W-W-------W-WWW
W-------W---------WW
W-W---W--W--W---W--W
W----W----W-----XW-W
W--------------W---W
WX----W---W--------W
W------------W----WW
WWWWWWWWWWWWWWWWWWWW
