WWWWWWWWWWWWWWWWWWWW
W----------WWW-X---W
W------------------W
W--------W--------WW
W------X--W----W---W
W------------W----WW
W----W-W-----W---WWW
W----WW--W-W--W----W
WX-----------------W
W----W---W--W---W--W
W--WW------W-WW---WW
W--W-W-----------W-W
W-W-------W-------WW
W-W-X---W---WW-----W
WW----W-----W------W
W-W-WW-----W-W-----W
W-W--WWW----X-W---XW
W---W--WW--W---W---W
W-W----W-------W-X-W
WWWWWWWWWWWWWWWWWWWW
