WWWWWWWWWWWWWWWWWWWW
W---------WW-------W
W---------WW-------W
W------WWWWWWW-----W
W------------------W
W------------X-----W
W-WWWWWWW----------W
W-WWWWWWW----------W
W-WWWWWWW-WWWWWW---W
W-WWWWWWW-WWWWWWWW-W
W-WWWWWWWWWW-WWWWW-W
W----WWWWWWW-WWWWW-W
W------WW----WWWWW-W
W------WW----WWWWW-W
W------------WWWWW-W
W-------------WWWW-W
W------------------W
W---------WWW------W
W------------------W
WWWWWWWWWWWWWWWWWWWW
