WWWWWWWWWWWWWWWWWWWW
W----------W-W--W--W
W--------W---------W
W--------------W-W-W
WW------W---W-----WW
W----W--W-W-WWW----W
W-W----WW--W------WW
W--W------------W-WW
WW-------W----W----W
WWWWX-----W--------W
W---------WWWWW-W-WW
W-W---X---------W--W
W--W----------WW-X-W
WW----W-WW--W-----WW
WW-W------WW-----WWW
W-W----------------W
W-WWW------WW-----WW
W---W--W------W--W-W
WW---WWW-------W---W
WWWWWWWWWWWWWWWWWWWW
