WWWWWWWWWWWWWWWWWWWW
W-------W--W-------W
W----------------W-W
W------------W----WW
WWWW----W--W-W----WW
W-------W---XW-----W
W--------W-W-------W
W---X----W--------WW
WW---W-WX----------W
W--W---WW------W---W
W-------W--WW--W---W
W--W-----WWW-------W
W--W-W-W--W--------W
W-------W--------W-W
W-W-----W--W-----W-W
W------W--W-W--W---W
W------------------W
WW--------W--------W
W--------WW--W-W---W
WWWWWWWWWWWWWWWWWWWW
