WWWWWWWWWWWWWWWWWWWW
W----W---W---------W
W-------W-W---W-W--W
W---W--------W---W-W
W-------W-------W--W
W-W-----W------WWWWW
W----------------W-W
W---W---W---WWXW---W
W---------WW-------W
W-----------WW----WW
W---------W---WW---W
W-----W--W------W--W
WX-------X---W----WW
W--------X----W--W-W
W--W-W----------WW-W
W----W---WW-------WW
W-WX---------------W
W-----------W--W--WW
W-X------------W--WW
WWWWWWWWWWWWWWWWWWWW
