WWWWWWWWWWWWWWWWWWWW
W------------------W
W---WWWWWW-X-------W
W------------------W
W-------------X----W
W---WWWWW----------W
W---WWWWW---X------W
W---WWWWW----------W
W---WWWWW----------W
W---WWWWW---X------W
W------------------W
W------W------W----W
W------W------W----W
W------WWWWW--W--WWW
W------WWWWW--W--WWW
WWW----WWWWW--W--WWW
WWW----WWWWW--W--WWW
WWWWWWWWWWWW-----WWW
WWWWWWWWWWWW-----WWW
WWWWWWWWWWWWWWWWWWWW
