WWWWWWWWWWWWWWWWWWWW
W----X----------W--W
W------W---W-WW-WWWW
W---W--W---------W-W
W-WW--W-W--W--W---WW
W----W-W---WW-X----W
W--W---------W-----W
W-----W--------W--WW
W-W----------W-----W
WW-WW---W-W---W--W-W
W-W--W-------W-----W
W-----WWW--W------WW
W-W--W------W-----WW
W----W-----WW------W
W------W-----W-W--WW
WW----W---WW---W---W
W-W-W--------W-----W
W--W--W-----------WW
W-W-W----W-W----WW-W
WWWWWWWWWWWWWWWWWWWW
