WWWWWWWWWWWWWWWWWWWW
W-------------W-W--W
W------------W-----W
W--------W---WW----W
W---W-W-W----W-W---W
W------------------W
W---WW-WW----W---WWW
W---------W--------W
W--W-------W-------W
W---W-W--------WW--W
W---W-W--X---------W
W-WW--WW-----W--WWWW
W--W--W---------WW-W
W-------------W-W--W
W---W--------------W
WW----W--------W-W-W
W----W-XWW-----WW-WW
W------WW-W--------W
W--W-W------------WW
WWWWWWWWWWWWWWWWWWWW
