WWWWWWWWWWWWWWWWWWWW
W----------------W-W
W----------W----W--W
W---WW---W---X-----W
W--W----------WW---W
W-W---W--W-W-------W
W-------W--W--W---XW
W--X---W---W-------W
W-W----W---W------WW
W----X--W--W-------W
W-------W-----W-X--W
W-----W------------W
W--WW--W-----------W
W-----W--W---W-W---W
W---------------W--W
W----WW-----W------W
W--------------X-WWW
W-W-----WW-----WW-WW
W-WW---WW-W--------W
WWWWWWWWWWWWWWWWWWWW
