WWWWWWWWWWWWWWWWWWWW
W------------WWWWWWW
W------------------W
W------------------W
W------------------W
W------------------W
W-WWWWWWW----------W
W-WWWWWWW----------W
W-WWWWWWWWWW-------W
W-WWWWWWW----------W
W-WWWWWWW----W-----W
W-WWWWWWW----W-----W
W---WWWWWX---W-----W
W-----------WWWWWWWW
W-----------WWWWWWWW
WWWWWWWWW---WWWWWWWW
WW-WWW----X-WWWWWWWW
WW-WWW------WWWWWWWW
WW-WWW-------------W
WWWWWWWWWWWWWWWWWWWW
