WWWWWWWWWWWWWWWWWWWW
W-------------WWWWWW
W--------WWWW-WWWWWW
W--------WWWW-WWWWWW
W--------WWWW-WWWWWW
W--------WWWW-WWWWWW
W--------WWWW--WWWWW
W--------WWWW-W----W
W------------------W
W----------X-------W
W---WWWWWW-----WWW-W
W---WWWWWW-----WWW-W
W---WWWWWW-----WWW-W
W--------------WWW-W
W--WWW-------------W
W------------WWWWWWW
W------X-----WWWWWWW
W------------WWWWW-W
W------------------W
WWWWWWWWWWWWWWWWWWWW
