WWWWWWWWWWWWWWWWWWWW
W------------XWW---W
W-------------WW-WWW
W---------WWW-WW-WWW
W---------WWWWWWW--W
W---------WWWWWWW--W
W-------WWWWWWWWW--W
W---------WWWWWWW--W
W---------WWWWWWW--W
W---------WWWWWWW--W
WWWWWW----WWWWWWW--W
WWWWWWW-------WW---W
WWWWWW-------WWWWW-W
WWWWWW-------------W
WWWWWW-------------W
WWWWWW-------------W
W-WWW--------------W
W-WWW--------------W
W-WWW--------------W
WWWWWWWWWWWWWWWWWWWW
