WWWWWWWWWWWWWWWWWWWW
W-----W--------W--WW
W---W-WW--W------W-W
W---W----WW-WW---W-W
W----W----W----W-W-W
W-----------X-W---WW
W------------------W
W---------W-W------W
W-W---W--W--W------W
W--W-W---W----X----W
WWW-----W------WWW-W
W--W-W-W---X------WW
WW-------W---W---W-W
W----W-W---WW------W
W-WWWWW---W-W--WX--W
W----W---W-W----W--W
W------W----------WW
W------WW-WW--W----W
W-----W-------W--W-W
WWWWWWWWWWWWWWWWWWWW
