WWWWWWWWWWWWWWWWWWWW
W--------------X---W
W------------------W
W------------------W
W------------------W
W---------------WWWW
W--------WWWWWW-WWWW
W--------WWWWWW-WWWW
W---------WWWWWWWWWW
W---------WWWWWWWW-W
W-------WWWWWWWWWW-W
W---------WWWWWWWW-W
W--------X-WWWWWWW-W
W-----WWWWWWWWWWWW-W
W-----WWWWWWWWWWWW-W
W-----WWWWWWW-X-X--W
W-----WWWWWWWW-----W
W------WWWWWWW----XW
W----X-WWWWWWW-----W
WWWWWWWWWWWWWWWWWWWW
