WWWWWWWWWWWWWWWWWWWW
W------------------W
W------------------W
W-------W-W--------W
W-----------WW-----W
W---------------W-WW
W---W----------W--XW
W--------WWW---W--WW
W--------------W---W
W-------------WW---W
W-----W-------WWWW-W
WWW--W--------WW---W
W-------------WW---W
W--W----------W----W
W--------WWW--W----W
W---------W--WW----W
W------------------W
W--WWWWWW-WW-WW-WWWW
X------------------W
WWWWWWWWWWWWWWWWWWWW
