WWWWWWWWWWWWWWWWWWWW
W---------W--------W
W------------------W
W------WW------WW--W
W------------------W
W---------------W--W
WWWWWW--WW------W--W
W-------WW-----WWX-W
W-------WW----WW---W
W------------------W
WWWWW--------------W
WWW---W---------W--W
W---W-W-W-------W--W
WWW----------W--WW-W
WWW----------------W
W------------------W
W----------W------XW
WWWWWW-WWWWWWWWWWW-W
WW-----------------W
WWWWWWWWWWWWWWWWWWWW
