WWWWWWWWWWWWWWWWWWWW
W------------------W
W------------------W
W---------W------WWW
W----------------X-W
W------------------W
W---W-------------WW
W-----------W------W
W------WW----W-W---W
W------WW------W---W
WWW-----W----W-W---W
W------------------W
W-W-W------------WWW
WWW--------W------XW
W-----------------WW
WW-------W-WWW----WW
WWW--------W-----W-W
WWWWWWWWWW-----WWW-W
W------------------W
WWWWWWWWWWWWWWWWWWWW
