WWWWWWWWWWWWWWWWWWWW
W------------------W
W------------------W
W-------X--WW------W
W----------WWW-----W
W----------WW------W
W-XW------------WW-W
W--WW---------W----W
WW-------W----W----W
W--------WW-WX-----W
WW-------WW--------W
W------------------W
W------------WW----W
W---W-------WWW-WWWW
W---W------WWW-----W
WW---------WW------W
W-WW-----W--W-----WW
WW----WW----WW-----W
W------------------W
WWWWWWWWWWWWWWWWWWWW
