WWWWWWWWWWWWWWWWWWWW
W-------W-W--------W
W------------------W
W-------------X----W
W----WWW-----------W
WWWW-------W--W----W
W-------------WW---W
W------------W-W---W
W------------------W
W----------------WWW
WWWWWW----WWWWWWW--W
WWWXWW--WWWX-XW----W
WWWW----W-W---W-WWWW
W------------------W
W-----------------WW
W-----WW-------W---W
WWW------------X---W
WWW--W---WXWWWW----W
W------------------W
WWWWWWWWWWWWWWWWWWWW
