WWWWWWWWWWWWWWWWWWWW
-------------W-----W
W------------------W
W------------W----XW
W------------------W
W-------W---------WW
W------W---------W-W
WWWWWWWW-----------W
WWW----------------W
W--------------W---W
W--------------W---W
W--WW--WW----------W
W------------------W
W--------------W---W
W-WWWWWWWWW--WWW---W
W-W-WW------------XW
W----W--------W----W
W-------WWWWWWW----W
W------------------W
WWWWWWWWWWWWWWWWWWWW
