WWWWWWWWWWWWWWWWWWWW
W------------------W
W------------------W
W----W-------------W
W----W------W------W
WW----------------XW
WW-------W--------WW
W-----------WWWWWWWW
WWWWWW----WWW-----WW
W-----------W---W-WW
WWWWWW-W--W-W-----XW
W-------WW--W---W-WW
W-----------------XW
W--W------W-----W-WW
W--W---------------W
W---W--------------W
WW-----------------W
WWWWWWWW---WWWWWWWWW
W------------------W
WWWWWWWWWWWWWWWWWWWW
