WWWWWWWWWWWWWWWWWWWW
W-------------W----W
W-------------W----W
W------W-W----W----W
W----WWW-----------W
W-WW---------------W
W------------------W
W-------------W-WX-W
W--W----------W----W
W-------------WWW--W
W--W----------W----W
W------W------W----W
WW--WWW-------WW-W-W
W-----W------------W
WW----W------------W
W-----W----W----W--W
W-----W--WWW------XW
WWW---WWW--------W-W
W------------------W
WWWWWWWWWWWWWWWWWWWW
