WWWWWWWWWWWWWWWWWWWW
W------------------W
W------------------W
W----WW--------WW--W
W----X--WW-----W-W-W
W--WW----------WWW-W
W--------W-----W---W
WWW---W--W---------W
W------------W----WW
W------------------W
W------------WW----W
W------------------W
W------------WWW---W
W------------------W
W------W---W-----W-W
W---WW-----W-------W
W---------WW-------W
WWWW---------WWWWWWW
W------------------W
WWWWWWWWWWWWWWWWWWWW
