WWWWWWWWWWWWWWWWWWWW
W------------------W
W------------------W
W--------W-----WW--W
W-------XW-W-W-----W
W-W------W------WWWW
WXW------------WWW-W
W------------WWW---W
W------------------W
W-W----------------W
WW----WX----W--WWWWW
WW-----------------W
W------W----------WW
WW-----WWW---------W
WWWW---------------W
W---------------WWWW
W-WW-W-------------W
W-----WWWWWWWWWWWWWW
W------------------W
WWWWWWWWWWWWWWWWWWWW
