WWWWWWWWWWWWWWWWWWWW
W------------------W
W------------------W
W------------------W
W---------------WWWW
W-----W----W------XW
W-------------W----W
W------------------W
W------W------W----W
WW------------W----W
W---------W--WW----W
W---------------W--W
W-------W----------W
W-W----------WWWWWWW
W-WW--------------XW
W------W----W--WW-WW
W------------------W
WWWWWWWWWWWW----WWWW
W------------------W
WWWWWWWWWWWWWWWWWWWW
