WWWWWWWWWWWWWWWWWWWW
W------------------W
W------------------W
W-------------WWW--W
W----W-------------W
W---W-----W--------W
WW--------W----X---W
WWW-------W---W----W
W------------------W
WWW-----WWWW--WW---W
W------------------W
WWW-----WWWWW------W
W------------------W
W------W-----------W
WW----------WWWW---W
WWWW-----------W--WW
WX------W-W--W-W---W
W-WWWWWWW-W--------W
W------------------W
WWWWWWWWWWWWWWWWWWWW
