WWWWWWWWWWWWWWWWWWWW
W------------------W
W------------------W
W------W-----------W
W------------------W
WWWWW-----------W--W
W------X-----------W
W---------WW-------W
W---------------W--W
W---------------W--W
W-W-W--------------W
W-W----------------W
WX--WWW------------W
W---------W--WW---XW
W-W----------W---W-W
W-WW---WW----W-----W
W------------------W
WWW--W-WWWWW-WWWWWWW
W------------------W
WWWWWWWWWWWWWWWWWWWW
