WWWWWWWWWWWWWWWWWWWW
W------------------W
W------------------W
W------------------W
W------WW----W-----W
WWW----W-----W-----W
W-W----W--WWWW-----W
W------------------W
W------WW----W-----W
W------X-----W----XW
W-----WW---------W-W
W--W-W------WWWW---W
W------W----W------W
W----W------W------W
W----W------W------W
WWW--W--W----------W
WX--------------W--W
WWWWWWWWWWW--WWWWW-W
W------------------W
WWWWWWWWWWWWWWWWWWWW
