WWWWWWWWWWWWWWWWWWWW
W----------------W-W
W-----WW---------X-W
W------------------W
W------------------W
WWW--W------X------W
W----WW------------W
W--------X---------W
W-W--W---W--WW-----W
WW-------WW-W------W
WWW---------------WW
W------W-----------W
W----------X-------W
W-------WWWWW------W
W---W-W------------W
W------------------W
WW--WW----WWW-----XW
WW---------------W-W
W------------------W
WWWWWWWWWWWWWWWWWWWW
