WWWWWWWWWWWWWWWWWWWW
W------------------W
W------------------W
W------------------W
W--------------WWWWW
WWW---W-------W----W
W-X------W---------W
WWW----------------W
W-------------WW---W
WWW------------W---W
WWW---------W----W-W
W-----------W------W
W--WW------------W-W
W--XW---X----------W
W---W------------W-W
W---W-------W----WWW
WWWWWWW------------W
WWW----------WWW-W-W
WWX----------------W
WWWWWWWWWWWWWWWWWWWW
