WWWWWWWWWWWWWWWWWWWW
W------------------W
W------------------W
W------------------W
W------------------W
W-------WW------W--W
W------WWW----W----W
W---WWW-W----------W
WWW--------W-------W
W-----------------WW
W---W-W-W-----WW--XW
W-----W-------WW---W
W-WWW-------W------W
W-W---------W--W---W
W-----------WW-W---W
W------X----W------W
W-----------W--WWWWW
WWW--W-WWWWWWWWWWWWW
W------------------W
WWWWWWWWWWWWWWWWWWWW
