WWWWWWWWWWWWWWWWWWWW
W------------------W
W------------------W
W------------------W
W------WWW---------W
W--------------W---W
W-W-WWW-------WW---W
W----------------WWW
WW-----------------W
W---WW-WWW---WWW---W
W----W--WW----W----W
WWWW----------W----W
W-------------W---XW
WW------------WW--WW
W----WW-W---------WW
WW---W--WW--W-----WW
W----W---------W--WW
WWWWWWWWWWWWWW-WWWWW
W----X-------------W
WWWWWWWWWWWWWWWWWWWW
