WWWWWWWWWWWWWWWWWWWW
W------------------W
W------------------W
X---------W-------WW
W------------------W
W-W---WWWWWW-------W
W-----------WWWW---W
W-WW---------------W
W-W----------------W
W------------------W
W-W----------W-W-W-W
W-W----------------W
W-WW--W-----WW-----W
W-WW---------------W
W------------------W
W------------------W
W--WWW----------WW-W
WWWWWWW--WWWWW-W---W
W------------------W
WWWWWWWWWWWWWWWWWWWW
