WWWWWWWWWWWWWWWWWWWW
W------------------W
W------------------W
W-----WW-------WW--W
W------WW-----W----W
WWWWW--------------W
W------------------W
WWW-W--W--------X--W
WWW-W-WW-W---------W
WWW-WWWWW----------W
WWW-W-WW-WWW-W-----W
W------------W--W--W
W------------W-----W
W------W-W---------W
W------------------W
WW----WW------W----W
WWW------------W---W
WX------WWWWWW-WW--W
W------------------W
WWWWWWWWWWWWWWWWWWWW
