WWWWWWWWWWWWWWWWWWWW
W------------------W
W------------------W
W-----W---W---WWW--W
W-----W--W----WW---W
WW-------------W---W
W--------------W---W
WX----W------WWW---W
WW---------W---W---W
W---------WWW-WW---W
W------------------W
W-----------W--W---W
W---W--------WW----W
W-WW----W----------W
W------------------W
W----W----W--------W
WW---W---WW---WWW--W
WWWWWWW-----------WW
WW-----------------W
WWWWWWWWWWWWWWWWWWWW
