WWWWWWWWWWWWWWWWWWWW
W------------------W
W------------------W
W-----------------XW
W--------W---------W
W--------------WW-XW
W-------W----WWWWWWW
W-WWW--------------W
W---W------WWW----WW
W---WWWWWW---------W
W-----------W--W--WW
W----W------W--WW--W
W-WWW-----WWW-----XW
W-W-----W--WW------W
W-------WW-W-------W
W----W-----W-------W
W-W--------------W-W
WWWWW--WWWWWWW-----W
W------------------W
WWWWWWWWWWWWWWWWWWWW
