WWWWWWWWWWWWWWWWWWWW
W------------------W
W------------------W
W-----------------XW
W----WW------W---W-W
WW--------W-WW--WW-W
W------W--W------WWW
WWW---WW-----------W
W------W-----------W
W-WW----------W----W
W------------------W
W---W------W--WW---W
W---WW--------W----W
WWW--W-----W--W----W
W----WW----W-------W
W---W-----WW-------W
W-----------------XW
WWW----WWW-WWWWWWW-W
W------------------W
WWWWWWWWWWWWWWWWWWWW
