WWWWWWWWWWWWWWWWWWWW
W------------------W
W------------------W
W--------WWWWWW-W--W
W--------X---------W
W------------WWWWWWW
W---------W--------W
W--------W--W------W
WX---------WW------W
W------W-------WW-XW
WWWW---------------W
W------------------W
W-WW-------WW-WW---W
W---------W----W---W
W---------W----W---W
WWW----------------W
W---------------W-WW
WWW-WWW-----WWWWW--W
W------------------W
WWWWWWWWWWWWWWWWWWWW
