WWWWWWWWWWWWWWWWWWWW
W------------------W
W------------------W
W-----------W------W
W--------W--W----W-W
W--W-WWWW--------W-W
W--W---------------W
W--W--WWWW---------W
W--W---------------W
W--W-----W---------W
W--------W----W----W
W--------W----W---XW
WWW-----------W---WW
W-WW----W-----W----W
WWW----WW------W--WW
W----------W---W--WW
WW--------------W--W
WWWWW-WWWW---WW----W
WX-----------------W
WWWWWWWWWWWWWWWWWWWW
