WWWWWWWWWWWWWWWWWWWW
W------W--W--------W
W------------------W
W------WW--------X-W
W------W--X----WW--W
W--------WW-------WW
W------WWWW--------W
W------W--W-----W-WW
WW---WWW--W--------W
W---------------W-WW
W------------------W
W-W--------W-------W
W------------------W
W----------WW-W----W
W--------W--------WW
WWW---------------WW
WX---------W----W-WW
WWWWW------W-WWWW-WW
W------------------W
WWWWWWWWWWWWWWWWWWWW
