WWWWWWWWWWWWWWWWWWWW
W------------------W
W------------------W
W--------WW--------W
W--------W------W-WW
W-----W-W---------WW
WWW---------------WW
W-------WW-WW--W---W
W----------WW--W-W-W
W------------------W
W----WW--WWWW----WWW
WWW------------W---W
W------W------WW---W
WWW----------------W
W--------------W---W
W-W--------------WXW
WXW-------------W--W
W-------WWWWWWW-W--W
W------------------W
WWWWWWWWWWWWWWWWWWWW
